*************************************************
*   *           *   *         *           *     *
*** * *** ***** * * *** ***** *** ***** * ***** *
*   *   * *   *   * *   *       *   * * *     * *
* * **E * * * ***** * * ******* *** * * ***** * *
* * *   *   * *   *   * *     * *   * * *   *   *
* *** ******* * * * ***** *** * * *** * * * *** *
*           * * *   *       * * *   * *   * *   *
* ******* *** * ***** ******* * *** * ***** * ***
* * *   * *   *     *   *     * *     *     *   *
* * * * * * * ********* * ***** ***** * ******* *
*   * * * * * *   *     * *   *     * * * *     *
***** * *** * * * * ***** * * ***** * * * * *****
*     *     * * *   *   *   *   * * * * * *     *
* * ********* * ***** * ******* * * * * * ***** *
* * *   *     *       * * *     *   * * *       *
* *** * *************** * * ***** ***** ******* *
*   * * *       *     *   *   *         *     * *
* * * * * ***** * *** *** *** *********** *** * *
* *   *   *   * *   * *   * * *           *   * *
* ********* * * * *** * *** * * *********** *****
*     *     * *   *   * *   *   *       *   *   *
******* ***** *** * *** * * ***** ***** * *** * *
*     *     *   * *   *   * *   *     * *     * *
* *** ***** *** ***** ***** *** * *** ********* *
* *     *   * *     *   * *   * * * *     *   * *
* ***** * *** ***** * * * *** * * * *** *** * * *
*     *   *       *   * *   * *       * *   *   *
* *** ***** ***** ***** *** * ********* * *******
* *   *       *     *   *   *     *     *    S* *
* * *** ***** ***** * *** * ***** * *** ******* *
* * * *     *     * *   * * *     * *   *   *   *
* * * ***** ***** ***** * *** ***** * *** * * * *
* * * *     * *   *     * *   *     *     *   * *
* * * * ***** * * * ***** * *** *************** *
* * * *   *   * * * *   * *     *   *     *     *
* * * *** * * * *** * * * ******* * * *** * *****
* * *   * * * *   *   * *   *     *   *   *   * *
*** * * * * * *** ***** * * * ********* ***** * *
*   * *     *   * *     * * *   *     * * *   * *
* *********** *** * ***** * *** * ***** * * *** *
*           * *   *   *   *     *   *     * *   *
* ********* * * ***** * ********* * * ***** * * *
* *       * * *     * * *         *     *   * * *
* *** * *** * ***** * * ******* ********* *** * *
*   * *   * * *   *     *     * *   *   * *   * *
*** ***** * *** * ******* *** *** * * * * *** * *
*         *     *           *     *   *       * *
*************************************************
BLOCK[0][0] Texture: blackSquare.bmp	Moveable?: *false
BLOCK[0][1] Texture: blackSquare.bmp	Moveable?: *false
BLOCK[0][2] Texture: blackSquare.bmp	Moveable?: *false
BLOCK[0][3] Texture: blackSquare.bmp	Moveable?: *false
BLOCK[0][4] Texture: blackSquare.bmp	Moveable?: *false
BLOCK[0][5] Texture: blackSquare.bmp	Moveable?: *false
BLOCK[0][6] Texture: blackSquare.bmp	Moveable?: *false
BLOCK[0][7] Texture: blackSquare.bmp	Moveable?: *false
BLOCK[0][8] Texture: blackSquare.bmp	Moveable?: *false
BLOCK[0][9] Texture: blackSquare.bmp	Moveable?: *false
BLOCK[0][10] Texture: blackSquare.bmp	Moveable?: *false
BLOCK[0][11] Texture: blackSquare.bmp	Moveable?: *false
BLOCK[0][12] Texture: blackSquare.bmp	Moveable?: *false
BLOCK[0][13] Texture: blackSquare.bmp	Moveable?: *false
BLOCK[0][14] Texture: blackSquare.bmp	Moveable?: *false
BLOCK[0][15] Texture: blackSquare.bmp	Moveable?: *false
BLOCK[0][16] Texture: blackSquare.bmp	Moveable?: *false
BLOCK[0][17] Texture: blackSquare.bmp	Moveable?: *false
BLOCK[0][18] Texture: blackSquare.bmp	Moveable?: *false
BLOCK[0][19] Texture: blackSquare.bmp	Moveable?: *false
BLOCK[0][20] Texture: blackSquare.bmp	Moveable?: *false
BLOCK[0][21] Texture: blackSquare.bmp	Moveable?: *false
BLOCK[0][22] Texture: blackSquare.bmp	Moveable?: *false
BLOCK[0][23] Texture: blackSquare.bmp	Moveable?: *false
BLOCK[0][24] Texture: blackSquare.bmp	Moveable?: *false
BLOCK[0][25] Texture: blackSquare.bmp	Moveable?: *false
BLOCK[0][26] Texture: blackSquare.bmp	Moveable?: *false
BLOCK[0][27] Texture: blackSquare.bmp	Moveable?: *false
BLOCK[0][28] Texture: blackSquare.bmp	Moveable?: *false
BLOCK[0][29] Texture: blackSquare.bmp	Moveable?: *false
BLOCK[0][30] Texture: blackSquare.bmp	Moveable?: *false
BLOCK[0][31] Texture: blackSquare.bmp	Moveable?: *false
BLOCK[0][32] Texture: blackSquare.bmp	Moveable?: *false
BLOCK[0][33] Texture: blackSquare.bmp	Moveable?: *false
BLOCK[0][34] Texture: blackSquare.bmp	Moveable?: *false
BLOCK[0][35] Texture: blackSquare.bmp	Moveable?: *false
BLOCK[0][36] Texture: blackSquare.bmp	Moveable?: *false
BLOCK[0][37] Texture: blackSquare.bmp	Moveable?: *false
BLOCK[0][38] Texture: blackSquare.bmp	Moveable?: *false
BLOCK[0][39] Texture: blackSquare.bmp	Moveable?: *false
BLOCK[0][40] Texture: blackSquare.bmp	Moveable?: *false
BLOCK[0][41] Texture: blackSquare.bmp	Moveable?: *false
BLOCK[0][42] Texture: blackSquare.bmp	Moveable?: *false
BLOCK[0][43] Texture: blackSquare.bmp	Moveable?: *false
BLOCK[0][44] Texture: blackSquare.bmp	Moveable?: *false
BLOCK[0][45] Texture: blackSquare.bmp	Moveable?: *false
BLOCK[0][46] Texture: blackSquare.bmp	Moveable?: *false
BLOCK[0][47] Texture: blackSquare.bmp	Moveable?: *false
BLOCK[0][48] Texture: blackSquare.bmp	Moveable?: *false
BLOCK[1][0] Texture: blackSquare.bmp	Moveable?: *false
BLOCK[1][1] Texture: whiteSquare.bmp	Moveable?:  true
BLOCK[1][2] Texture: whiteSquare.bmp	Moveable?:  true
BLOCK[1][3] Texture: whiteSquare.bmp	Moveable?:  true
BLOCK[1][4] Texture: blackSquare.bmp	Moveable?: *false
BLOCK[1][5] Texture: whiteSquare.bmp	Moveable?:  true
BLOCK[1][6] Texture: whiteSquare.bmp	Moveable?:  true
BLOCK[1][7] Texture: whiteSquare.bmp	Moveable?:  true
BLOCK[1][8] Texture: whiteSquare.bmp	Moveable?:  true
BLOCK[1][9] Texture: whiteSquare.bmp	Moveable?:  true
BLOCK[1][10] Texture: whiteSquare.bmp	Moveable?:  true
BLOCK[1][11] Texture: whiteSquare.bmp	Moveable?:  true
BLOCK[1][12] Texture: whiteSquare.bmp	Moveable?:  true
BLOCK[1][13] Texture: whiteSquare.bmp	Moveable?:  true
BLOCK[1][14] Texture: whiteSquare.bmp	Moveable?:  true
BLOCK[1][15] Texture: whiteSquare.bmp	Moveable?:  true
BLOCK[1][16] Texture: blackSquare.bmp	Moveable?: *false
BLOCK[1][17] Texture: whiteSquare.bmp	Moveable?:  true
BLOCK[1][18] Texture: whiteSquare.bmp	Moveable?:  true
BLOCK[1][19] Texture: whiteSquare.bmp	Moveable?:  true
BLOCK[1][20] Texture: blackSquare.bmp	Moveable?: *false
BLOCK[1][21] Texture: whiteSquare.bmp	Moveable?:  true
BLOCK[1][22] Texture: whiteSquare.bmp	Moveable?:  true
BLOCK[1][23] Texture: whiteSquare.bmp	Moveable?:  true
BLOCK[1][24] Texture: whiteSquare.bmp	Moveable?:  true
BLOCK[1][25] Texture: whiteSquare.bmp	Moveable?:  true
BLOCK[1][26] Texture: whiteSquare.bmp	Moveable?:  true
BLOCK[1][27] Texture: whiteSquare.bmp	Moveable?:  true
BLOCK[1][28] Texture: whiteSquare.bmp	Moveable?:  true
BLOCK[1][29] Texture: whiteSquare.bmp	Moveable?:  true
BLOCK[1][30] Texture: blackSquare.bmp	Moveable?: *false
BLOCK[1][31] Texture: whiteSquare.bmp	Moveable?:  true
BLOCK[1][32] Texture: whiteSquare.bmp	Moveable?:  true
BLOCK[1][33] Texture: whiteSquare.bmp	Moveable?:  true
BLOCK[1][34] Texture: whiteSquare.bmp	Moveable?:  true
BLOCK[1][35] Texture: whiteSquare.bmp	Moveable?:  true
BLOCK[1][36] Texture: whiteSquare.bmp	Moveable?:  true
BLOCK[1][37] Texture: whiteSquare.bmp	Moveable?:  true
BLOCK[1][38] Texture: whiteSquare.bmp	Moveable?:  true
BLOCK[1][39] Texture: whiteSquare.bmp	Moveable?:  true
BLOCK[1][40] Texture: whiteSquare.bmp	Moveable?:  true
BLOCK[1][41] Texture: whiteSquare.bmp	Moveable?:  true
BLOCK[1][42] Texture: blackSquare.bmp	Moveable?: *false
BLOCK[1][43] Texture: whiteSquare.bmp	Moveable?:  true
BLOCK[1][44] Texture: whiteSquare.bmp	Moveable?:  true
BLOCK[1][45] Texture: whiteSquare.bmp	Moveable?:  true
BLOCK[1][46] Texture: whiteSquare.bmp	Moveable?:  true
BLOCK[1][47] Texture: whiteSquare.bmp	Moveable?:  true
BLOCK[1][48] Texture: blackSquare.bmp	Moveable?: *false
BLOCK[2][0] Texture: blackSquare.bmp	Moveable?: *false
BLOCK[2][1] Texture: blackSquare.bmp	Moveable?: *false
BLOCK[2][2] Texture: blackSquare.bmp	Moveable?: *false
BLOCK[2][3] Texture: whiteSquare.bmp	Moveable?:  true
BLOCK[2][4] Texture: blackSquare.bmp	Moveable?: *false
BLOCK[2][5] Texture: whiteSquare.bmp	Moveable?:  true
BLOCK[2][6] Texture: blackSquare.bmp	Moveable?: *false
BLOCK[2][7] Texture: blackSquare.bmp	Moveable?: *false
BLOCK[2][8] Texture: blackSquare.bmp	Moveable?: *false
BLOCK[2][9] Texture: whiteSquare.bmp	Moveable?:  true
BLOCK[2][10] Texture: blackSquare.bmp	Moveable?: *false
BLOCK[2][11] Texture: blackSquare.bmp	Moveable?: *false
BLOCK[2][12] Texture: blackSquare.bmp	Moveable?: *false
BLOCK[2][13] Texture: blackSquare.bmp	Moveable?: *false
BLOCK[2][14] Texture: blackSquare.bmp	Moveable?: *false
BLOCK[2][15] Texture: whiteSquare.bmp	Moveable?:  true
BLOCK[2][16] Texture: blackSquare.bmp	Moveable?: *false
BLOCK[2][17] Texture: whiteSquare.bmp	Moveable?:  true
BLOCK[2][18] Texture: blackSquare.bmp	Moveable?: *false
BLOCK[2][19] Texture: whiteSquare.bmp	Moveable?:  true
BLOCK[2][20] Texture: blackSquare.bmp	Moveable?: *false
BLOCK[2][21] Texture: blackSquare.bmp	Moveable?: *false
BLOCK[2][22] Texture: blackSquare.bmp	Moveable?: *false
BLOCK[2][23] Texture: whiteSquare.bmp	Moveable?:  true
BLOCK[2][24] Texture: blackSquare.bmp	Moveable?: *false
BLOCK[2][25] Texture: blackSquare.bmp	Moveable?: *false
BLOCK[2][26] Texture: blackSquare.bmp	Moveable?: *false
BLOCK[2][27] Texture: blackSquare.bmp	Moveable?: *false
BLOCK[2][28] Texture: blackSquare.bmp	Moveable?: *false
BLOCK[2][29] Texture: whiteSquare.bmp	Moveable?:  true
BLOCK[2][30] Texture: blackSquare.bmp	Moveable?: *false
BLOCK[2][31] Texture: blackSquare.bmp	Moveable?: *false
BLOCK[2][32] Texture: blackSquare.bmp	Moveable?: *false
BLOCK[2][33] Texture: whiteSquare.bmp	Moveable?:  true
BLOCK[2][34] Texture: blackSquare.bmp	Moveable?: *false
BLOCK[2][35] Texture: blackSquare.bmp	Moveable?: *false
BLOCK[2][36] Texture: blackSquare.bmp	Moveable?: *false
BLOCK[2][37] Texture: blackSquare.bmp	Moveable?: *false
BLOCK[2][38] Texture: blackSquare.bmp	Moveable?: *false
BLOCK[2][39] Texture: whiteSquare.bmp	Moveable?:  true
BLOCK[2][40] Texture: blackSquare.bmp	Moveable?: *false
BLOCK[2][41] Texture: whiteSquare.bmp	Moveable?:  true
BLOCK[2][42] Texture: blackSquare.bmp	Moveable?: *false
BLOCK[2][43] Texture: blackSquare.bmp	Moveable?: *false
BLOCK[2][44] Texture: blackSquare.bmp	Moveable?: *false
BLOCK[2][45] Texture: blackSquare.bmp	Moveable?: *false
BLOCK[2][46] Texture: blackSquare.bmp	Moveable?: *false
BLOCK[2][47] Texture: whiteSquare.bmp	Moveable?:  true
BLOCK[2][48] Texture: blackSquare.bmp	Moveable?: *false
BLOCK[3][0] Texture: blackSquare.bmp	Moveable?: *false
BLOCK[3][1] Texture: whiteSquare.bmp	Moveable?:  true
BLOCK[3][2] Texture: whiteSquare.bmp	Moveable?:  true
BLOCK[3][3] Texture: whiteSquare.bmp	Moveable?:  true
BLOCK[3][4] Texture: blackSquare.bmp	Moveable?: *false
BLOCK[3][5] Texture: whiteSquare.bmp	Moveable?:  true
BLOCK[3][6] Texture: whiteSquare.bmp	Moveable?:  true
BLOCK[3][7] Texture: whiteSquare.bmp	Moveable?:  true
BLOCK[3][8] Texture: blackSquare.bmp	Moveable?: *false
BLOCK[3][9] Texture: whiteSquare.bmp	Moveable?:  true
BLOCK[3][10] Texture: blackSquare.bmp	Moveable?: *false
BLOCK[3][11] Texture: whiteSquare.bmp	Moveable?:  true
BLOCK[3][12] Texture: whiteSquare.bmp	Moveable?:  true
BLOCK[3][13] Texture: whiteSquare.bmp	Moveable?:  true
BLOCK[3][14] Texture: blackSquare.bmp	Moveable?: *false
BLOCK[3][15] Texture: whiteSquare.bmp	Moveable?:  true
BLOCK[3][16] Texture: whiteSquare.bmp	Moveable?:  true
BLOCK[3][17] Texture: whiteSquare.bmp	Moveable?:  true
BLOCK[3][18] Texture: blackSquare.bmp	Moveable?: *false
BLOCK[3][19] Texture: whiteSquare.bmp	Moveable?:  true
BLOCK[3][20] Texture: blackSquare.bmp	Moveable?: *false
BLOCK[3][21] Texture: whiteSquare.bmp	Moveable?:  true
BLOCK[3][22] Texture: whiteSquare.bmp	Moveable?:  true
BLOCK[3][23] Texture: whiteSquare.bmp	Moveable?:  true
BLOCK[3][24] Texture: blackSquare.bmp	Moveable?: *false
BLOCK[3][25] Texture: whiteSquare.bmp	Moveable?:  true
BLOCK[3][26] Texture: whiteSquare.bmp	Moveable?:  true
BLOCK[3][27] Texture: whiteSquare.bmp	Moveable?:  true
BLOCK[3][28] Texture: whiteSquare.bmp	Moveable?:  true
BLOCK[3][29] Texture: whiteSquare.bmp	Moveable?:  true
BLOCK[3][30] Texture: whiteSquare.bmp	Moveable?:  true
BLOCK[3][31] Texture: whiteSquare.bmp	Moveable?:  true
BLOCK[3][32] Texture: blackSquare.bmp	Moveable?: *false
BLOCK[3][33] Texture: whiteSquare.bmp	Moveable?:  true
BLOCK[3][34] Texture: whiteSquare.bmp	Moveable?:  true
BLOCK[3][35] Texture: whiteSquare.bmp	Moveable?:  true
BLOCK[3][36] Texture: blackSquare.bmp	Moveable?: *false
BLOCK[3][37] Texture: whiteSquare.bmp	Moveable?:  true
BLOCK[3][38] Texture: blackSquare.bmp	Moveable?: *false
BLOCK[3][39] Texture: whiteSquare.bmp	Moveable?:  true
BLOCK[3][40] Texture: blackSquare.bmp	Moveable?: *false
BLOCK[3][41] Texture: whiteSquare.bmp	Moveable?:  true
BLOCK[3][42] Texture: whiteSquare.bmp	Moveable?:  true
BLOCK[3][43] Texture: whiteSquare.bmp	Moveable?:  true
BLOCK[3][44] Texture: whiteSquare.bmp	Moveable?:  true
BLOCK[3][45] Texture: whiteSquare.bmp	Moveable?:  true
BLOCK[3][46] Texture: blackSquare.bmp	Moveable?: *false
BLOCK[3][47] Texture: whiteSquare.bmp	Moveable?:  true
BLOCK[3][48] Texture: blackSquare.bmp	Moveable?: *false
BLOCK[4][0] Texture: blackSquare.bmp	Moveable?: *false
BLOCK[4][1] Texture: whiteSquare.bmp	Moveable?:  true
BLOCK[4][2] Texture: blackSquare.bmp	Moveable?: *false
BLOCK[4][3] Texture: whiteSquare.bmp	Moveable?:  true
BLOCK[4][4] Texture: blackSquare.bmp	Moveable?: *false
BLOCK[4][5] Texture: blackSquare.bmp	Moveable?: *false
BLOCK[4][6] Texture: whiteSquare.bmp	Moveable?: Etrue
BLOCK[4][7] Texture: whiteSquare.bmp	Moveable?:  true
BLOCK[4][8] Texture: blackSquare.bmp	Moveable?: *false
BLOCK[4][9] Texture: whiteSquare.bmp	Moveable?:  true
BLOCK[4][10] Texture: blackSquare.bmp	Moveable?: *false
BLOCK[4][11] Texture: whiteSquare.bmp	Moveable?:  true
BLOCK[4][12] Texture: blackSquare.bmp	Moveable?: *false
BLOCK[4][13] Texture: whiteSquare.bmp	Moveable?:  true
BLOCK[4][14] Texture: blackSquare.bmp	Moveable?: *false
BLOCK[4][15] Texture: blackSquare.bmp	Moveable?: *false
BLOCK[4][16] Texture: blackSquare.bmp	Moveable?: *false
BLOCK[4][17] Texture: blackSquare.bmp	Moveable?: *false
BLOCK[4][18] Texture: blackSquare.bmp	Moveable?: *false
BLOCK[4][19] Texture: whiteSquare.bmp	Moveable?:  true
BLOCK[4][20] Texture: blackSquare.bmp	Moveable?: *false
BLOCK[4][21] Texture: whiteSquare.bmp	Moveable?:  true
BLOCK[4][22] Texture: blackSquare.bmp	Moveable?: *false
BLOCK[4][23] Texture: whiteSquare.bmp	Moveable?:  true
BLOCK[4][24] Texture: blackSquare.bmp	Moveable?: *false
BLOCK[4][25] Texture: blackSquare.bmp	Moveable?: *false
BLOCK[4][26] Texture: blackSquare.bmp	Moveable?: *false
BLOCK[4][27] Texture: blackSquare.bmp	Moveable?: *false
BLOCK[4][28] Texture: blackSquare.bmp	Moveable?: *false
BLOCK[4][29] Texture: blackSquare.bmp	Moveable?: *false
BLOCK[4][30] Texture: blackSquare.bmp	Moveable?: *false
BLOCK[4][31] Texture: whiteSquare.bmp	Moveable?:  true
BLOCK[4][32] Texture: blackSquare.bmp	Moveable?: *false
BLOCK[4][33] Texture: blackSquare.bmp	Moveable?: *false
BLOCK[4][34] Texture: blackSquare.bmp	Moveable?: *false
BLOCK[4][35] Texture: whiteSquare.bmp	Moveable?:  true
BLOCK[4][36] Texture: blackSquare.bmp	Moveable?: *false
BLOCK[4][37] Texture: whiteSquare.bmp	Moveable?:  true
BLOCK[4][38] Texture: blackSquare.bmp	Moveable?: *false
BLOCK[4][39] Texture: whiteSquare.bmp	Moveable?:  true
BLOCK[4][40] Texture: blackSquare.bmp	Moveable?: *false
BLOCK[4][41] Texture: blackSquare.bmp	Moveable?: *false
BLOCK[4][42] Texture: blackSquare.bmp	Moveable?: *false
BLOCK[4][43] Texture: blackSquare.bmp	Moveable?: *false
BLOCK[4][44] Texture: blackSquare.bmp	Moveable?: *false
BLOCK[4][45] Texture: whiteSquare.bmp	Moveable?:  true
BLOCK[4][46] Texture: blackSquare.bmp	Moveable?: *false
BLOCK[4][47] Texture: whiteSquare.bmp	Moveable?:  true
BLOCK[4][48] Texture: blackSquare.bmp	Moveable?: *false
BLOCK[5][0] Texture: blackSquare.bmp	Moveable?: *false
BLOCK[5][1] Texture: whiteSquare.bmp	Moveable?:  true
BLOCK[5][2] Texture: blackSquare.bmp	Moveable?: *false
BLOCK[5][3] Texture: whiteSquare.bmp	Moveable?:  true
BLOCK[5][4] Texture: blackSquare.bmp	Moveable?: *false
BLOCK[5][5] Texture: whiteSquare.bmp	Moveable?:  true
BLOCK[5][6] Texture: whiteSquare.bmp	Moveable?:  true
BLOCK[5][7] Texture: whiteSquare.bmp	Moveable?:  true
BLOCK[5][8] Texture: blackSquare.bmp	Moveable?: *false
BLOCK[5][9] Texture: whiteSquare.bmp	Moveable?:  true
BLOCK[5][10] Texture: whiteSquare.bmp	Moveable?:  true
BLOCK[5][11] Texture: whiteSquare.bmp	Moveable?:  true
BLOCK[5][12] Texture: blackSquare.bmp	Moveable?: *false
BLOCK[5][13] Texture: whiteSquare.bmp	Moveable?:  true
BLOCK[5][14] Texture: blackSquare.bmp	Moveable?: *false
BLOCK[5][15] Texture: whiteSquare.bmp	Moveable?:  true
BLOCK[5][16] Texture: whiteSquare.bmp	Moveable?:  true
BLOCK[5][17] Texture: whiteSquare.bmp	Moveable?:  true
BLOCK[5][18] Texture: blackSquare.bmp	Moveable?: *false
BLOCK[5][19] Texture: whiteSquare.bmp	Moveable?:  true
BLOCK[5][20] Texture: whiteSquare.bmp	Moveable?:  true
BLOCK[5][21] Texture: whiteSquare.bmp	Moveable?:  true
BLOCK[5][22] Texture: blackSquare.bmp	Moveable?: *false
BLOCK[5][23] Texture: whiteSquare.bmp	Moveable?:  true
BLOCK[5][24] Texture: blackSquare.bmp	Moveable?: *false
BLOCK[5][25] Texture: whiteSquare.bmp	Moveable?:  true
BLOCK[5][26] Texture: whiteSquare.bmp	Moveable?:  true
BLOCK[5][27] Texture: whiteSquare.bmp	Moveable?:  true
BLOCK[5][28] Texture: whiteSquare.bmp	Moveable?:  true
BLOCK[5][29] Texture: whiteSquare.bmp	Moveable?:  true
BLOCK[5][30] Texture: blackSquare.bmp	Moveable?: *false
BLOCK[5][31] Texture: whiteSquare.bmp	Moveable?:  true
BLOCK[5][32] Texture: blackSquare.bmp	Moveable?: *false
BLOCK[5][33] Texture: whiteSquare.bmp	Moveable?:  true
BLOCK[5][34] Texture: whiteSquare.bmp	Moveable?:  true
BLOCK[5][35] Texture: whiteSquare.bmp	Moveable?:  true
BLOCK[5][36] Texture: blackSquare.bmp	Moveable?: *false
BLOCK[5][37] Texture: whiteSquare.bmp	Moveable?:  true
BLOCK[5][38] Texture: blackSquare.bmp	Moveable?: *false
BLOCK[5][39] Texture: whiteSquare.bmp	Moveable?:  true
BLOCK[5][40] Texture: blackSquare.bmp	Moveable?: *false
BLOCK[5][41] Texture: whiteSquare.bmp	Moveable?:  true
BLOCK[5][42] Texture: whiteSquare.bmp	Moveable?:  true
BLOCK[5][43] Texture: whiteSquare.bmp	Moveable?:  true
BLOCK[5][44] Texture: blackSquare.bmp	Moveable?: *false
BLOCK[5][45] Texture: whiteSquare.bmp	Moveable?:  true
BLOCK[5][46] Texture: whiteSquare.bmp	Moveable?:  true
BLOCK[5][47] Texture: whiteSquare.bmp	Moveable?:  true
BLOCK[5][48] Texture: blackSquare.bmp	Moveable?: *false
BLOCK[6][0] Texture: blackSquare.bmp	Moveable?: *false
BLOCK[6][1] Texture: whiteSquare.bmp	Moveable?:  true
BLOCK[6][2] Texture: blackSquare.bmp	Moveable?: *false
BLOCK[6][3] Texture: blackSquare.bmp	Moveable?: *false
BLOCK[6][4] Texture: blackSquare.bmp	Moveable?: *false
BLOCK[6][5] Texture: whiteSquare.bmp	Moveable?:  true
BLOCK[6][6] Texture: blackSquare.bmp	Moveable?: *false
BLOCK[6][7] Texture: blackSquare.bmp	Moveable?: *false
BLOCK[6][8] Texture: blackSquare.bmp	Moveable?: *false
BLOCK[6][9] Texture: blackSquare.bmp	Moveable?: *false
BLOCK[6][10] Texture: blackSquare.bmp	Moveable?: *false
BLOCK[6][11] Texture: blackSquare.bmp	Moveable?: *false
BLOCK[6][12] Texture: blackSquare.bmp	Moveable?: *false
BLOCK[6][13] Texture: whiteSquare.bmp	Moveable?:  true
BLOCK[6][14] Texture: blackSquare.bmp	Moveable?: *false
BLOCK[6][15] Texture: whiteSquare.bmp	Moveable?:  true
BLOCK[6][16] Texture: blackSquare.bmp	Moveable?: *false
BLOCK[6][17] Texture: whiteSquare.bmp	Moveable?:  true
BLOCK[6][18] Texture: blackSquare.bmp	Moveable?: *false
BLOCK[6][19] Texture: whiteSquare.bmp	Moveable?:  true
BLOCK[6][20] Texture: blackSquare.bmp	Moveable?: *false
BLOCK[6][21] Texture: blackSquare.bmp	Moveable?: *false
BLOCK[6][22] Texture: blackSquare.bmp	Moveable?: *false
BLOCK[6][23] Texture: blackSquare.bmp	Moveable?: *false
BLOCK[6][24] Texture: blackSquare.bmp	Moveable?: *false
BLOCK[6][25] Texture: whiteSquare.bmp	Moveable?:  true
BLOCK[6][26] Texture: blackSquare.bmp	Moveable?: *false
BLOCK[6][27] Texture: blackSquare.bmp	Moveable?: *false
BLOCK[6][28] Texture: blackSquare.bmp	Moveable?: *false
BLOCK[6][29] Texture: whiteSquare.bmp	Moveable?:  true
BLOCK[6][30] Texture: blackSquare.bmp	Moveable?: *false
BLOCK[6][31] Texture: whiteSquare.bmp	Moveable?:  true
BLOCK[6][32] Texture: blackSquare.bmp	Moveable?: *false
BLOCK[6][33] Texture: whiteSquare.bmp	Moveable?:  true
BLOCK[6][34] Texture: blackSquare.bmp	Moveable?: *false
BLOCK[6][35] Texture: blackSquare.bmp	Moveable?: *false
BLOCK[6][36] Texture: blackSquare.bmp	Moveable?: *false
BLOCK[6][37] Texture: whiteSquare.bmp	Moveable?:  true
BLOCK[6][38] Texture: blackSquare.bmp	Moveable?: *false
BLOCK[6][39] Texture: whiteSquare.bmp	Moveable?:  true
BLOCK[6][40] Texture: blackSquare.bmp	Moveable?: *false
BLOCK[6][41] Texture: whiteSquare.bmp	Moveable?:  true
BLOCK[6][42] Texture: blackSquare.bmp	Moveable?: *false
BLOCK[6][43] Texture: whiteSquare.bmp	Moveable?:  true
BLOCK[6][44] Texture: blackSquare.bmp	Moveable?: *false
BLOCK[6][45] Texture: blackSquare.bmp	Moveable?: *false
BLOCK[6][46] Texture: blackSquare.bmp	Moveable?: *false
BLOCK[6][47] Texture: whiteSquare.bmp	Moveable?:  true
BLOCK[6][48] Texture: blackSquare.bmp	Moveable?: *false
BLOCK[7][0] Texture: blackSquare.bmp	Moveable?: *false
BLOCK[7][1] Texture: whiteSquare.bmp	Moveable?:  true
BLOCK[7][2] Texture: whiteSquare.bmp	Moveable?:  true
BLOCK[7][3] Texture: whiteSquare.bmp	Moveable?:  true
BLOCK[7][4] Texture: whiteSquare.bmp	Moveable?:  true
BLOCK[7][5] Texture: whiteSquare.bmp	Moveable?:  true
BLOCK[7][6] Texture: whiteSquare.bmp	Moveable?:  true
BLOCK[7][7] Texture: whiteSquare.bmp	Moveable?:  true
BLOCK[7][8] Texture: whiteSquare.bmp	Moveable?:  true
BLOCK[7][9] Texture: whiteSquare.bmp	Moveable?:  true
BLOCK[7][10] Texture: whiteSquare.bmp	Moveable?:  true
BLOCK[7][11] Texture: whiteSquare.bmp	Moveable?:  true
BLOCK[7][12] Texture: blackSquare.bmp	Moveable?: *false
BLOCK[7][13] Texture: whiteSquare.bmp	Moveable?:  true
BLOCK[7][14] Texture: blackSquare.bmp	Moveable?: *false
BLOCK[7][15] Texture: whiteSquare.bmp	Moveable?:  true
BLOCK[7][16] Texture: blackSquare.bmp	Moveable?: *false
BLOCK[7][17] Texture: whiteSquare.bmp	Moveable?:  true
BLOCK[7][18] Texture: whiteSquare.bmp	Moveable?:  true
BLOCK[7][19] Texture: whiteSquare.bmp	Moveable?:  true
BLOCK[7][20] Texture: blackSquare.bmp	Moveable?: *false
BLOCK[7][21] Texture: whiteSquare.bmp	Moveable?:  true
BLOCK[7][22] Texture: whiteSquare.bmp	Moveable?:  true
BLOCK[7][23] Texture: whiteSquare.bmp	Moveable?:  true
BLOCK[7][24] Texture: whiteSquare.bmp	Moveable?:  true
BLOCK[7][25] Texture: whiteSquare.bmp	Moveable?:  true
BLOCK[7][26] Texture: whiteSquare.bmp	Moveable?:  true
BLOCK[7][27] Texture: whiteSquare.bmp	Moveable?:  true
BLOCK[7][28] Texture: blackSquare.bmp	Moveable?: *false
BLOCK[7][29] Texture: whiteSquare.bmp	Moveable?:  true
BLOCK[7][30] Texture: blackSquare.bmp	Moveable?: *false
BLOCK[7][31] Texture: whiteSquare.bmp	Moveable?:  true
BLOCK[7][32] Texture: blackSquare.bmp	Moveable?: *false
BLOCK[7][33] Texture: whiteSquare.bmp	Moveable?:  true
BLOCK[7][34] Texture: whiteSquare.bmp	Moveable?:  true
BLOCK[7][35] Texture: whiteSquare.bmp	Moveable?:  true
BLOCK[7][36] Texture: blackSquare.bmp	Moveable?: *false
BLOCK[7][37] Texture: whiteSquare.bmp	Moveable?:  true
BLOCK[7][38] Texture: blackSquare.bmp	Moveable?: *false
BLOCK[7][39] Texture: whiteSquare.bmp	Moveable?:  true
BLOCK[7][40] Texture: whiteSquare.bmp	Moveable?:  true
BLOCK[7][41] Texture: whiteSquare.bmp	Moveable?:  true
BLOCK[7][42] Texture: blackSquare.bmp	Moveable?: *false
BLOCK[7][43] Texture: whiteSquare.bmp	Moveable?:  true
BLOCK[7][44] Texture: blackSquare.bmp	Moveable?: *false
BLOCK[7][45] Texture: whiteSquare.bmp	Moveable?:  true
BLOCK[7][46] Texture: whiteSquare.bmp	Moveable?:  true
BLOCK[7][47] Texture: whiteSquare.bmp	Moveable?:  true
BLOCK[7][48] Texture: blackSquare.bmp	Moveable?: *false
BLOCK[8][0] Texture: blackSquare.bmp	Moveable?: *false
BLOCK[8][1] Texture: whiteSquare.bmp	Moveable?:  true
BLOCK[8][2] Texture: blackSquare.bmp	Moveable?: *false
BLOCK[8][3] Texture: blackSquare.bmp	Moveable?: *false
BLOCK[8][4] Texture: blackSquare.bmp	Moveable?: *false
BLOCK[8][5] Texture: blackSquare.bmp	Moveable?: *false
BLOCK[8][6] Texture: blackSquare.bmp	Moveable?: *false
BLOCK[8][7] Texture: blackSquare.bmp	Moveable?: *false
BLOCK[8][8] Texture: blackSquare.bmp	Moveable?: *false
BLOCK[8][9] Texture: whiteSquare.bmp	Moveable?:  true
BLOCK[8][10] Texture: blackSquare.bmp	Moveable?: *false
BLOCK[8][11] Texture: blackSquare.bmp	Moveable?: *false
BLOCK[8][12] Texture: blackSquare.bmp	Moveable?: *false
BLOCK[8][13] Texture: whiteSquare.bmp	Moveable?:  true
BLOCK[8][14] Texture: blackSquare.bmp	Moveable?: *false
BLOCK[8][15] Texture: whiteSquare.bmp	Moveable?:  true
BLOCK[8][16] Texture: blackSquare.bmp	Moveable?: *false
BLOCK[8][17] Texture: blackSquare.bmp	Moveable?: *false
BLOCK[8][18] Texture: blackSquare.bmp	Moveable?: *false
BLOCK[8][19] Texture: blackSquare.bmp	Moveable?: *false
BLOCK[8][20] Texture: blackSquare.bmp	Moveable?: *false
BLOCK[8][21] Texture: whiteSquare.bmp	Moveable?:  true
BLOCK[8][22] Texture: blackSquare.bmp	Moveable?: *false
BLOCK[8][23] Texture: blackSquare.bmp	Moveable?: *false
BLOCK[8][24] Texture: blackSquare.bmp	Moveable?: *false
BLOCK[8][25] Texture: blackSquare.bmp	Moveable?: *false
BLOCK[8][26] Texture: blackSquare.bmp	Moveable?: *false
BLOCK[8][27] Texture: blackSquare.bmp	Moveable?: *false
BLOCK[8][28] Texture: blackSquare.bmp	Moveable?: *false
BLOCK[8][29] Texture: whiteSquare.bmp	Moveable?:  true
BLOCK[8][30] Texture: blackSquare.bmp	Moveable?: *false
BLOCK[8][31] Texture: whiteSquare.bmp	Moveable?:  true
BLOCK[8][32] Texture: blackSquare.bmp	Moveable?: *false
BLOCK[8][33] Texture: blackSquare.bmp	Moveable?: *false
BLOCK[8][34] Texture: blackSquare.bmp	Moveable?: *false
BLOCK[8][35] Texture: whiteSquare.bmp	Moveable?:  true
BLOCK[8][36] Texture: blackSquare.bmp	Moveable?: *false
BLOCK[8][37] Texture: whiteSquare.bmp	Moveable?:  true
BLOCK[8][38] Texture: blackSquare.bmp	Moveable?: *false
BLOCK[8][39] Texture: blackSquare.bmp	Moveable?: *false
BLOCK[8][40] Texture: blackSquare.bmp	Moveable?: *false
BLOCK[8][41] Texture: blackSquare.bmp	Moveable?: *false
BLOCK[8][42] Texture: blackSquare.bmp	Moveable?: *false
BLOCK[8][43] Texture: whiteSquare.bmp	Moveable?:  true
BLOCK[8][44] Texture: blackSquare.bmp	Moveable?: *false
BLOCK[8][45] Texture: whiteSquare.bmp	Moveable?:  true
BLOCK[8][46] Texture: blackSquare.bmp	Moveable?: *false
BLOCK[8][47] Texture: blackSquare.bmp	Moveable?: *false
BLOCK[8][48] Texture: blackSquare.bmp	Moveable?: *false
BLOCK[9][0] Texture: blackSquare.bmp	Moveable?: *false
BLOCK[9][1] Texture: whiteSquare.bmp	Moveable?:  true
BLOCK[9][2] Texture: blackSquare.bmp	Moveable?: *false
BLOCK[9][3] Texture: whiteSquare.bmp	Moveable?:  true
BLOCK[9][4] Texture: blackSquare.bmp	Moveable?: *false
BLOCK[9][5] Texture: whiteSquare.bmp	Moveable?:  true
BLOCK[9][6] Texture: whiteSquare.bmp	Moveable?:  true
BLOCK[9][7] Texture: whiteSquare.bmp	Moveable?:  true
BLOCK[9][8] Texture: blackSquare.bmp	Moveable?: *false
BLOCK[9][9] Texture: whiteSquare.bmp	Moveable?:  true
BLOCK[9][10] Texture: blackSquare.bmp	Moveable?: *false
BLOCK[9][11] Texture: whiteSquare.bmp	Moveable?:  true
BLOCK[9][12] Texture: whiteSquare.bmp	Moveable?:  true
BLOCK[9][13] Texture: whiteSquare.bmp	Moveable?:  true
BLOCK[9][14] Texture: blackSquare.bmp	Moveable?: *false
BLOCK[9][15] Texture: whiteSquare.bmp	Moveable?:  true
BLOCK[9][16] Texture: whiteSquare.bmp	Moveable?:  true
BLOCK[9][17] Texture: whiteSquare.bmp	Moveable?:  true
BLOCK[9][18] Texture: whiteSquare.bmp	Moveable?:  true
BLOCK[9][19] Texture: whiteSquare.bmp	Moveable?:  true
BLOCK[9][20] Texture: blackSquare.bmp	Moveable?: *false
BLOCK[9][21] Texture: whiteSquare.bmp	Moveable?:  true
BLOCK[9][22] Texture: whiteSquare.bmp	Moveable?:  true
BLOCK[9][23] Texture: whiteSquare.bmp	Moveable?:  true
BLOCK[9][24] Texture: blackSquare.bmp	Moveable?: *false
BLOCK[9][25] Texture: whiteSquare.bmp	Moveable?:  true
BLOCK[9][26] Texture: whiteSquare.bmp	Moveable?:  true
BLOCK[9][27] Texture: whiteSquare.bmp	Moveable?:  true
BLOCK[9][28] Texture: whiteSquare.bmp	Moveable?:  true
BLOCK[9][29] Texture: whiteSquare.bmp	Moveable?:  true
BLOCK[9][30] Texture: blackSquare.bmp	Moveable?: *false
BLOCK[9][31] Texture: whiteSquare.bmp	Moveable?:  true
BLOCK[9][32] Texture: blackSquare.bmp	Moveable?: *false
BLOCK[9][33] Texture: whiteSquare.bmp	Moveable?:  true
BLOCK[9][34] Texture: whiteSquare.bmp	Moveable?:  true
BLOCK[9][35] Texture: whiteSquare.bmp	Moveable?:  true
BLOCK[9][36] Texture: whiteSquare.bmp	Moveable?:  true
BLOCK[9][37] Texture: whiteSquare.bmp	Moveable?:  true
BLOCK[9][38] Texture: blackSquare.bmp	Moveable?: *false
BLOCK[9][39] Texture: whiteSquare.bmp	Moveable?:  true
BLOCK[9][40] Texture: whiteSquare.bmp	Moveable?:  true
BLOCK[9][41] Texture: whiteSquare.bmp	Moveable?:  true
BLOCK[9][42] Texture: whiteSquare.bmp	Moveable?:  true
BLOCK[9][43] Texture: whiteSquare.bmp	Moveable?:  true
BLOCK[9][44] Texture: blackSquare.bmp	Moveable?: *false
BLOCK[9][45] Texture: whiteSquare.bmp	Moveable?:  true
BLOCK[9][46] Texture: whiteSquare.bmp	Moveable?:  true
BLOCK[9][47] Texture: whiteSquare.bmp	Moveable?:  true
BLOCK[9][48] Texture: blackSquare.bmp	Moveable?: *false
BLOCK[10][0] Texture: blackSquare.bmp	Moveable?: *false
BLOCK[10][1] Texture: whiteSquare.bmp	Moveable?:  true
BLOCK[10][2] Texture: blackSquare.bmp	Moveable?: *false
BLOCK[10][3] Texture: whiteSquare.bmp	Moveable?:  true
BLOCK[10][4] Texture: blackSquare.bmp	Moveable?: *false
BLOCK[10][5] Texture: whiteSquare.bmp	Moveable?:  true
BLOCK[10][6] Texture: blackSquare.bmp	Moveable?: *false
BLOCK[10][7] Texture: whiteSquare.bmp	Moveable?:  true
BLOCK[10][8] Texture: blackSquare.bmp	Moveable?: *false
BLOCK[10][9] Texture: whiteSquare.bmp	Moveable?:  true
BLOCK[10][10] Texture: blackSquare.bmp	Moveable?: *false
BLOCK[10][11] Texture: whiteSquare.bmp	Moveable?:  true
BLOCK[10][12] Texture: blackSquare.bmp	Moveable?: *false
BLOCK[10][13] Texture: whiteSquare.bmp	Moveable?:  true
BLOCK[10][14] Texture: blackSquare.bmp	Moveable?: *false
BLOCK[10][15] Texture: blackSquare.bmp	Moveable?: *false
BLOCK[10][16] Texture: blackSquare.bmp	Moveable?: *false
BLOCK[10][17] Texture: blackSquare.bmp	Moveable?: *false
BLOCK[10][18] Texture: blackSquare.bmp	Moveable?: *false
BLOCK[10][19] Texture: blackSquare.bmp	Moveable?: *false
BLOCK[10][20] Texture: blackSquare.bmp	Moveable?: *false
BLOCK[10][21] Texture: blackSquare.bmp	Moveable?: *false
BLOCK[10][22] Texture: blackSquare.bmp	Moveable?: *false
BLOCK[10][23] Texture: whiteSquare.bmp	Moveable?:  true
BLOCK[10][24] Texture: blackSquare.bmp	Moveable?: *false
BLOCK[10][25] Texture: whiteSquare.bmp	Moveable?:  true
BLOCK[10][26] Texture: blackSquare.bmp	Moveable?: *false
BLOCK[10][27] Texture: blackSquare.bmp	Moveable?: *false
BLOCK[10][28] Texture: blackSquare.bmp	Moveable?: *false
BLOCK[10][29] Texture: blackSquare.bmp	Moveable?: *false
BLOCK[10][30] Texture: blackSquare.bmp	Moveable?: *false
BLOCK[10][31] Texture: whiteSquare.bmp	Moveable?:  true
BLOCK[10][32] Texture: blackSquare.bmp	Moveable?: *false
BLOCK[10][33] Texture: blackSquare.bmp	Moveable?: *false
BLOCK[10][34] Texture: blackSquare.bmp	Moveable?: *false
BLOCK[10][35] Texture: blackSquare.bmp	Moveable?: *false
BLOCK[10][36] Texture: blackSquare.bmp	Moveable?: *false
BLOCK[10][37] Texture: whiteSquare.bmp	Moveable?:  true
BLOCK[10][38] Texture: blackSquare.bmp	Moveable?: *false
BLOCK[10][39] Texture: whiteSquare.bmp	Moveable?:  true
BLOCK[10][40] Texture: blackSquare.bmp	Moveable?: *false
BLOCK[10][41] Texture: blackSquare.bmp	Moveable?: *false
BLOCK[10][42] Texture: blackSquare.bmp	Moveable?: *false
BLOCK[10][43] Texture: blackSquare.bmp	Moveable?: *false
BLOCK[10][44] Texture: blackSquare.bmp	Moveable?: *false
BLOCK[10][45] Texture: blackSquare.bmp	Moveable?: *false
BLOCK[10][46] Texture: blackSquare.bmp	Moveable?: *false
BLOCK[10][47] Texture: whiteSquare.bmp	Moveable?:  true
BLOCK[10][48] Texture: blackSquare.bmp	Moveable?: *false
BLOCK[11][0] Texture: blackSquare.bmp	Moveable?: *false
BLOCK[11][1] Texture: whiteSquare.bmp	Moveable?:  true
BLOCK[11][2] Texture: whiteSquare.bmp	Moveable?:  true
BLOCK[11][3] Texture: whiteSquare.bmp	Moveable?:  true
BLOCK[11][4] Texture: blackSquare.bmp	Moveable?: *false
BLOCK[11][5] Texture: whiteSquare.bmp	Moveable?:  true
BLOCK[11][6] Texture: blackSquare.bmp	Moveable?: *false
BLOCK[11][7] Texture: whiteSquare.bmp	Moveable?:  true
BLOCK[11][8] Texture: blackSquare.bmp	Moveable?: *false
BLOCK[11][9] Texture: whiteSquare.bmp	Moveable?:  true
BLOCK[11][10] Texture: blackSquare.bmp	Moveable?: *false
BLOCK[11][11] Texture: whiteSquare.bmp	Moveable?:  true
BLOCK[11][12] Texture: blackSquare.bmp	Moveable?: *false
BLOCK[11][13] Texture: whiteSquare.bmp	Moveable?:  true
BLOCK[11][14] Texture: blackSquare.bmp	Moveable?: *false
BLOCK[11][15] Texture: whiteSquare.bmp	Moveable?:  true
BLOCK[11][16] Texture: whiteSquare.bmp	Moveable?:  true
BLOCK[11][17] Texture: whiteSquare.bmp	Moveable?:  true
BLOCK[11][18] Texture: blackSquare.bmp	Moveable?: *false
BLOCK[11][19] Texture: whiteSquare.bmp	Moveable?:  true
BLOCK[11][20] Texture: whiteSquare.bmp	Moveable?:  true
BLOCK[11][21] Texture: whiteSquare.bmp	Moveable?:  true
BLOCK[11][22] Texture: whiteSquare.bmp	Moveable?:  true
BLOCK[11][23] Texture: whiteSquare.bmp	Moveable?:  true
BLOCK[11][24] Texture: blackSquare.bmp	Moveable?: *false
BLOCK[11][25] Texture: whiteSquare.bmp	Moveable?:  true
BLOCK[11][26] Texture: blackSquare.bmp	Moveable?: *false
BLOCK[11][27] Texture: whiteSquare.bmp	Moveable?:  true
BLOCK[11][28] Texture: whiteSquare.bmp	Moveable?:  true
BLOCK[11][29] Texture: whiteSquare.bmp	Moveable?:  true
BLOCK[11][30] Texture: blackSquare.bmp	Moveable?: *false
BLOCK[11][31] Texture: whiteSquare.bmp	Moveable?:  true
BLOCK[11][32] Texture: whiteSquare.bmp	Moveable?:  true
BLOCK[11][33] Texture: whiteSquare.bmp	Moveable?:  true
BLOCK[11][34] Texture: whiteSquare.bmp	Moveable?:  true
BLOCK[11][35] Texture: whiteSquare.bmp	Moveable?:  true
BLOCK[11][36] Texture: blackSquare.bmp	Moveable?: *false
BLOCK[11][37] Texture: whiteSquare.bmp	Moveable?:  true
BLOCK[11][38] Texture: blackSquare.bmp	Moveable?: *false
BLOCK[11][39] Texture: whiteSquare.bmp	Moveable?:  true
BLOCK[11][40] Texture: blackSquare.bmp	Moveable?: *false
BLOCK[11][41] Texture: whiteSquare.bmp	Moveable?:  true
BLOCK[11][42] Texture: blackSquare.bmp	Moveable?: *false
BLOCK[11][43] Texture: whiteSquare.bmp	Moveable?:  true
BLOCK[11][44] Texture: whiteSquare.bmp	Moveable?:  true
BLOCK[11][45] Texture: whiteSquare.bmp	Moveable?:  true
BLOCK[11][46] Texture: whiteSquare.bmp	Moveable?:  true
BLOCK[11][47] Texture: whiteSquare.bmp	Moveable?:  true
BLOCK[11][48] Texture: blackSquare.bmp	Moveable?: *false
BLOCK[12][0] Texture: blackSquare.bmp	Moveable?: *false
BLOCK[12][1] Texture: blackSquare.bmp	Moveable?: *false
BLOCK[12][2] Texture: blackSquare.bmp	Moveable?: *false
BLOCK[12][3] Texture: blackSquare.bmp	Moveable?: *false
BLOCK[12][4] Texture: blackSquare.bmp	Moveable?: *false
BLOCK[12][5] Texture: whiteSquare.bmp	Moveable?:  true
BLOCK[12][6] Texture: blackSquare.bmp	Moveable?: *false
BLOCK[12][7] Texture: whiteSquare.bmp	Moveable?:  true
BLOCK[12][8] Texture: blackSquare.bmp	Moveable?: *false
BLOCK[12][9] Texture: blackSquare.bmp	Moveable?: *false
BLOCK[12][10] Texture: blackSquare.bmp	Moveable?: *false
BLOCK[12][11] Texture: whiteSquare.bmp	Moveable?:  true
BLOCK[12][12] Texture: blackSquare.bmp	Moveable?: *false
BLOCK[12][13] Texture: whiteSquare.bmp	Moveable?:  true
BLOCK[12][14] Texture: blackSquare.bmp	Moveable?: *false
BLOCK[12][15] Texture: whiteSquare.bmp	Moveable?:  true
BLOCK[12][16] Texture: blackSquare.bmp	Moveable?: *false
BLOCK[12][17] Texture: whiteSquare.bmp	Moveable?:  true
BLOCK[12][18] Texture: blackSquare.bmp	Moveable?: *false
BLOCK[12][19] Texture: whiteSquare.bmp	Moveable?:  true
BLOCK[12][20] Texture: blackSquare.bmp	Moveable?: *false
BLOCK[12][21] Texture: blackSquare.bmp	Moveable?: *false
BLOCK[12][22] Texture: blackSquare.bmp	Moveable?: *false
BLOCK[12][23] Texture: blackSquare.bmp	Moveable?: *false
BLOCK[12][24] Texture: blackSquare.bmp	Moveable?: *false
BLOCK[12][25] Texture: whiteSquare.bmp	Moveable?:  true
BLOCK[12][26] Texture: blackSquare.bmp	Moveable?: *false
BLOCK[12][27] Texture: whiteSquare.bmp	Moveable?:  true
BLOCK[12][28] Texture: blackSquare.bmp	Moveable?: *false
BLOCK[12][29] Texture: whiteSquare.bmp	Moveable?:  true
BLOCK[12][30] Texture: blackSquare.bmp	Moveable?: *false
BLOCK[12][31] Texture: blackSquare.bmp	Moveable?: *false
BLOCK[12][32] Texture: blackSquare.bmp	Moveable?: *false
BLOCK[12][33] Texture: blackSquare.bmp	Moveable?: *false
BLOCK[12][34] Texture: blackSquare.bmp	Moveable?: *false
BLOCK[12][35] Texture: whiteSquare.bmp	Moveable?:  true
BLOCK[12][36] Texture: blackSquare.bmp	Moveable?: *false
BLOCK[12][37] Texture: whiteSquare.bmp	Moveable?:  true
BLOCK[12][38] Texture: blackSquare.bmp	Moveable?: *false
BLOCK[12][39] Texture: whiteSquare.bmp	Moveable?:  true
BLOCK[12][40] Texture: blackSquare.bmp	Moveable?: *false
BLOCK[12][41] Texture: whiteSquare.bmp	Moveable?:  true
BLOCK[12][42] Texture: blackSquare.bmp	Moveable?: *false
BLOCK[12][43] Texture: whiteSquare.bmp	Moveable?:  true
BLOCK[12][44] Texture: blackSquare.bmp	Moveable?: *false
BLOCK[12][45] Texture: blackSquare.bmp	Moveable?: *false
BLOCK[12][46] Texture: blackSquare.bmp	Moveable?: *false
BLOCK[12][47] Texture: blackSquare.bmp	Moveable?: *false
BLOCK[12][48] Texture: blackSquare.bmp	Moveable?: *false
BLOCK[13][0] Texture: blackSquare.bmp	Moveable?: *false
BLOCK[13][1] Texture: whiteSquare.bmp	Moveable?:  true
BLOCK[13][2] Texture: whiteSquare.bmp	Moveable?:  true
BLOCK[13][3] Texture: whiteSquare.bmp	Moveable?:  true
BLOCK[13][4] Texture: whiteSquare.bmp	Moveable?:  true
BLOCK[13][5] Texture: whiteSquare.bmp	Moveable?:  true
BLOCK[13][6] Texture: blackSquare.bmp	Moveable?: *false
BLOCK[13][7] Texture: whiteSquare.bmp	Moveable?:  true
BLOCK[13][8] Texture: whiteSquare.bmp	Moveable?:  true
BLOCK[13][9] Texture: whiteSquare.bmp	Moveable?:  true
BLOCK[13][10] Texture: whiteSquare.bmp	Moveable?:  true
BLOCK[13][11] Texture: whiteSquare.bmp	Moveable?:  true
BLOCK[13][12] Texture: blackSquare.bmp	Moveable?: *false
BLOCK[13][13] Texture: whiteSquare.bmp	Moveable?:  true
BLOCK[13][14] Texture: blackSquare.bmp	Moveable?: *false
BLOCK[13][15] Texture: whiteSquare.bmp	Moveable?:  true
BLOCK[13][16] Texture: blackSquare.bmp	Moveable?: *false
BLOCK[13][17] Texture: whiteSquare.bmp	Moveable?:  true
BLOCK[13][18] Texture: whiteSquare.bmp	Moveable?:  true
BLOCK[13][19] Texture: whiteSquare.bmp	Moveable?:  true
BLOCK[13][20] Texture: blackSquare.bmp	Moveable?: *false
BLOCK[13][21] Texture: whiteSquare.bmp	Moveable?:  true
BLOCK[13][22] Texture: whiteSquare.bmp	Moveable?:  true
BLOCK[13][23] Texture: whiteSquare.bmp	Moveable?:  true
BLOCK[13][24] Texture: blackSquare.bmp	Moveable?: *false
BLOCK[13][25] Texture: whiteSquare.bmp	Moveable?:  true
BLOCK[13][26] Texture: whiteSquare.bmp	Moveable?:  true
BLOCK[13][27] Texture: whiteSquare.bmp	Moveable?:  true
BLOCK[13][28] Texture: blackSquare.bmp	Moveable?: *false
BLOCK[13][29] Texture: whiteSquare.bmp	Moveable?:  true
BLOCK[13][30] Texture: whiteSquare.bmp	Moveable?:  true
BLOCK[13][31] Texture: whiteSquare.bmp	Moveable?:  true
BLOCK[13][32] Texture: blackSquare.bmp	Moveable?: *false
BLOCK[13][33] Texture: whiteSquare.bmp	Moveable?:  true
BLOCK[13][34] Texture: blackSquare.bmp	Moveable?: *false
BLOCK[13][35] Texture: whiteSquare.bmp	Moveable?:  true
BLOCK[13][36] Texture: blackSquare.bmp	Moveable?: *false
BLOCK[13][37] Texture: whiteSquare.bmp	Moveable?:  true
BLOCK[13][38] Texture: blackSquare.bmp	Moveable?: *false
BLOCK[13][39] Texture: whiteSquare.bmp	Moveable?:  true
BLOCK[13][40] Texture: blackSquare.bmp	Moveable?: *false
BLOCK[13][41] Texture: whiteSquare.bmp	Moveable?:  true
BLOCK[13][42] Texture: blackSquare.bmp	Moveable?: *false
BLOCK[13][43] Texture: whiteSquare.bmp	Moveable?:  true
BLOCK[13][44] Texture: whiteSquare.bmp	Moveable?:  true
BLOCK[13][45] Texture: whiteSquare.bmp	Moveable?:  true
BLOCK[13][46] Texture: whiteSquare.bmp	Moveable?:  true
BLOCK[13][47] Texture: whiteSquare.bmp	Moveable?:  true
BLOCK[13][48] Texture: blackSquare.bmp	Moveable?: *false
BLOCK[14][0] Texture: blackSquare.bmp	Moveable?: *false
BLOCK[14][1] Texture: whiteSquare.bmp	Moveable?:  true
BLOCK[14][2] Texture: blackSquare.bmp	Moveable?: *false
BLOCK[14][3] Texture: whiteSquare.bmp	Moveable?:  true
BLOCK[14][4] Texture: blackSquare.bmp	Moveable?: *false
BLOCK[14][5] Texture: blackSquare.bmp	Moveable?: *false
BLOCK[14][6] Texture: blackSquare.bmp	Moveable?: *false
BLOCK[14][7] Texture: blackSquare.bmp	Moveable?: *false
BLOCK[14][8] Texture: blackSquare.bmp	Moveable?: *false
BLOCK[14][9] Texture: blackSquare.bmp	Moveable?: *false
BLOCK[14][10] Texture: blackSquare.bmp	Moveable?: *false
BLOCK[14][11] Texture: blackSquare.bmp	Moveable?: *false
BLOCK[14][12] Texture: blackSquare.bmp	Moveable?: *false
BLOCK[14][13] Texture: whiteSquare.bmp	Moveable?:  true
BLOCK[14][14] Texture: blackSquare.bmp	Moveable?: *false
BLOCK[14][15] Texture: whiteSquare.bmp	Moveable?:  true
BLOCK[14][16] Texture: blackSquare.bmp	Moveable?: *false
BLOCK[14][17] Texture: blackSquare.bmp	Moveable?: *false
BLOCK[14][18] Texture: blackSquare.bmp	Moveable?: *false
BLOCK[14][19] Texture: blackSquare.bmp	Moveable?: *false
BLOCK[14][20] Texture: blackSquare.bmp	Moveable?: *false
BLOCK[14][21] Texture: whiteSquare.bmp	Moveable?:  true
BLOCK[14][22] Texture: blackSquare.bmp	Moveable?: *false
BLOCK[14][23] Texture: whiteSquare.bmp	Moveable?:  true
BLOCK[14][24] Texture: blackSquare.bmp	Moveable?: *false
BLOCK[14][25] Texture: blackSquare.bmp	Moveable?: *false
BLOCK[14][26] Texture: blackSquare.bmp	Moveable?: *false
BLOCK[14][27] Texture: blackSquare.bmp	Moveable?: *false
BLOCK[14][28] Texture: blackSquare.bmp	Moveable?: *false
BLOCK[14][29] Texture: blackSquare.bmp	Moveable?: *false
BLOCK[14][30] Texture: blackSquare.bmp	Moveable?: *false
BLOCK[14][31] Texture: whiteSquare.bmp	Moveable?:  true
BLOCK[14][32] Texture: blackSquare.bmp	Moveable?: *false
BLOCK[14][33] Texture: whiteSquare.bmp	Moveable?:  true
BLOCK[14][34] Texture: blackSquare.bmp	Moveable?: *false
BLOCK[14][35] Texture: whiteSquare.bmp	Moveable?:  true
BLOCK[14][36] Texture: blackSquare.bmp	Moveable?: *false
BLOCK[14][37] Texture: whiteSquare.bmp	Moveable?:  true
BLOCK[14][38] Texture: blackSquare.bmp	Moveable?: *false
BLOCK[14][39] Texture: whiteSquare.bmp	Moveable?:  true
BLOCK[14][40] Texture: blackSquare.bmp	Moveable?: *false
BLOCK[14][41] Texture: whiteSquare.bmp	Moveable?:  true
BLOCK[14][42] Texture: blackSquare.bmp	Moveable?: *false
BLOCK[14][43] Texture: blackSquare.bmp	Moveable?: *false
BLOCK[14][44] Texture: blackSquare.bmp	Moveable?: *false
BLOCK[14][45] Texture: blackSquare.bmp	Moveable?: *false
BLOCK[14][46] Texture: blackSquare.bmp	Moveable?: *false
BLOCK[14][47] Texture: whiteSquare.bmp	Moveable?:  true
BLOCK[14][48] Texture: blackSquare.bmp	Moveable?: *false
BLOCK[15][0] Texture: blackSquare.bmp	Moveable?: *false
BLOCK[15][1] Texture: whiteSquare.bmp	Moveable?:  true
BLOCK[15][2] Texture: blackSquare.bmp	Moveable?: *false
BLOCK[15][3] Texture: whiteSquare.bmp	Moveable?:  true
BLOCK[15][4] Texture: blackSquare.bmp	Moveable?: *false
BLOCK[15][5] Texture: whiteSquare.bmp	Moveable?:  true
BLOCK[15][6] Texture: whiteSquare.bmp	Moveable?:  true
BLOCK[15][7] Texture: whiteSquare.bmp	Moveable?:  true
BLOCK[15][8] Texture: blackSquare.bmp	Moveable?: *false
BLOCK[15][9] Texture: whiteSquare.bmp	Moveable?:  true
BLOCK[15][10] Texture: whiteSquare.bmp	Moveable?:  true
BLOCK[15][11] Texture: whiteSquare.bmp	Moveable?:  true
BLOCK[15][12] Texture: whiteSquare.bmp	Moveable?:  true
BLOCK[15][13] Texture: whiteSquare.bmp	Moveable?:  true
BLOCK[15][14] Texture: blackSquare.bmp	Moveable?: *false
BLOCK[15][15] Texture: whiteSquare.bmp	Moveable?:  true
BLOCK[15][16] Texture: whiteSquare.bmp	Moveable?:  true
BLOCK[15][17] Texture: whiteSquare.bmp	Moveable?:  true
BLOCK[15][18] Texture: whiteSquare.bmp	Moveable?:  true
BLOCK[15][19] Texture: whiteSquare.bmp	Moveable?:  true
BLOCK[15][20] Texture: whiteSquare.bmp	Moveable?:  true
BLOCK[15][21] Texture: whiteSquare.bmp	Moveable?:  true
BLOCK[15][22] Texture: blackSquare.bmp	Moveable?: *false
BLOCK[15][23] Texture: whiteSquare.bmp	Moveable?:  true
BLOCK[15][24] Texture: blackSquare.bmp	Moveable?: *false
BLOCK[15][25] Texture: whiteSquare.bmp	Moveable?:  true
BLOCK[15][26] Texture: blackSquare.bmp	Moveable?: *false
BLOCK[15][27] Texture: whiteSquare.bmp	Moveable?:  true
BLOCK[15][28] Texture: whiteSquare.bmp	Moveable?:  true
BLOCK[15][29] Texture: whiteSquare.bmp	Moveable?:  true
BLOCK[15][30] Texture: whiteSquare.bmp	Moveable?:  true
BLOCK[15][31] Texture: whiteSquare.bmp	Moveable?:  true
BLOCK[15][32] Texture: blackSquare.bmp	Moveable?: *false
BLOCK[15][33] Texture: whiteSquare.bmp	Moveable?:  true
BLOCK[15][34] Texture: whiteSquare.bmp	Moveable?:  true
BLOCK[15][35] Texture: whiteSquare.bmp	Moveable?:  true
BLOCK[15][36] Texture: blackSquare.bmp	Moveable?: *false
BLOCK[15][37] Texture: whiteSquare.bmp	Moveable?:  true
BLOCK[15][38] Texture: blackSquare.bmp	Moveable?: *false
BLOCK[15][39] Texture: whiteSquare.bmp	Moveable?:  true
BLOCK[15][40] Texture: blackSquare.bmp	Moveable?: *false
BLOCK[15][41] Texture: whiteSquare.bmp	Moveable?:  true
BLOCK[15][42] Texture: whiteSquare.bmp	Moveable?:  true
BLOCK[15][43] Texture: whiteSquare.bmp	Moveable?:  true
BLOCK[15][44] Texture: whiteSquare.bmp	Moveable?:  true
BLOCK[15][45] Texture: whiteSquare.bmp	Moveable?:  true
BLOCK[15][46] Texture: whiteSquare.bmp	Moveable?:  true
BLOCK[15][47] Texture: whiteSquare.bmp	Moveable?:  true
BLOCK[15][48] Texture: blackSquare.bmp	Moveable?: *false
BLOCK[16][0] Texture: blackSquare.bmp	Moveable?: *false
BLOCK[16][1] Texture: whiteSquare.bmp	Moveable?:  true
BLOCK[16][2] Texture: blackSquare.bmp	Moveable?: *false
BLOCK[16][3] Texture: blackSquare.bmp	Moveable?: *false
BLOCK[16][4] Texture: blackSquare.bmp	Moveable?: *false
BLOCK[16][5] Texture: whiteSquare.bmp	Moveable?:  true
BLOCK[16][6] Texture: blackSquare.bmp	Moveable?: *false
BLOCK[16][7] Texture: whiteSquare.bmp	Moveable?:  true
BLOCK[16][8] Texture: blackSquare.bmp	Moveable?: *false
BLOCK[16][9] Texture: blackSquare.bmp	Moveable?: *false
BLOCK[16][10] Texture: blackSquare.bmp	Moveable?: *false
BLOCK[16][11] Texture: blackSquare.bmp	Moveable?: *false
BLOCK[16][12] Texture: blackSquare.bmp	Moveable?: *false
BLOCK[16][13] Texture: blackSquare.bmp	Moveable?: *false
BLOCK[16][14] Texture: blackSquare.bmp	Moveable?: *false
BLOCK[16][15] Texture: blackSquare.bmp	Moveable?: *false
BLOCK[16][16] Texture: blackSquare.bmp	Moveable?: *false
BLOCK[16][17] Texture: blackSquare.bmp	Moveable?: *false
BLOCK[16][18] Texture: blackSquare.bmp	Moveable?: *false
BLOCK[16][19] Texture: blackSquare.bmp	Moveable?: *false
BLOCK[16][20] Texture: blackSquare.bmp	Moveable?: *false
BLOCK[16][21] Texture: blackSquare.bmp	Moveable?: *false
BLOCK[16][22] Texture: blackSquare.bmp	Moveable?: *false
BLOCK[16][23] Texture: whiteSquare.bmp	Moveable?:  true
BLOCK[16][24] Texture: blackSquare.bmp	Moveable?: *false
BLOCK[16][25] Texture: whiteSquare.bmp	Moveable?:  true
BLOCK[16][26] Texture: blackSquare.bmp	Moveable?: *false
BLOCK[16][27] Texture: whiteSquare.bmp	Moveable?:  true
BLOCK[16][28] Texture: blackSquare.bmp	Moveable?: *false
BLOCK[16][29] Texture: blackSquare.bmp	Moveable?: *false
BLOCK[16][30] Texture: blackSquare.bmp	Moveable?: *false
BLOCK[16][31] Texture: blackSquare.bmp	Moveable?: *false
BLOCK[16][32] Texture: blackSquare.bmp	Moveable?: *false
BLOCK[16][33] Texture: whiteSquare.bmp	Moveable?:  true
BLOCK[16][34] Texture: blackSquare.bmp	Moveable?: *false
BLOCK[16][35] Texture: blackSquare.bmp	Moveable?: *false
BLOCK[16][36] Texture: blackSquare.bmp	Moveable?: *false
BLOCK[16][37] Texture: blackSquare.bmp	Moveable?: *false
BLOCK[16][38] Texture: blackSquare.bmp	Moveable?: *false
BLOCK[16][39] Texture: whiteSquare.bmp	Moveable?:  true
BLOCK[16][40] Texture: blackSquare.bmp	Moveable?: *false
BLOCK[16][41] Texture: blackSquare.bmp	Moveable?: *false
BLOCK[16][42] Texture: blackSquare.bmp	Moveable?: *false
BLOCK[16][43] Texture: blackSquare.bmp	Moveable?: *false
BLOCK[16][44] Texture: blackSquare.bmp	Moveable?: *false
BLOCK[16][45] Texture: blackSquare.bmp	Moveable?: *false
BLOCK[16][46] Texture: blackSquare.bmp	Moveable?: *false
BLOCK[16][47] Texture: whiteSquare.bmp	Moveable?:  true
BLOCK[16][48] Texture: blackSquare.bmp	Moveable?: *false
BLOCK[17][0] Texture: blackSquare.bmp	Moveable?: *false
BLOCK[17][1] Texture: whiteSquare.bmp	Moveable?:  true
BLOCK[17][2] Texture: whiteSquare.bmp	Moveable?:  true
BLOCK[17][3] Texture: whiteSquare.bmp	Moveable?:  true
BLOCK[17][4] Texture: blackSquare.bmp	Moveable?: *false
BLOCK[17][5] Texture: whiteSquare.bmp	Moveable?:  true
BLOCK[17][6] Texture: blackSquare.bmp	Moveable?: *false
BLOCK[17][7] Texture: whiteSquare.bmp	Moveable?:  true
BLOCK[17][8] Texture: blackSquare.bmp	Moveable?: *false
BLOCK[17][9] Texture: whiteSquare.bmp	Moveable?:  true
BLOCK[17][10] Texture: whiteSquare.bmp	Moveable?:  true
BLOCK[17][11] Texture: whiteSquare.bmp	Moveable?:  true
BLOCK[17][12] Texture: whiteSquare.bmp	Moveable?:  true
BLOCK[17][13] Texture: whiteSquare.bmp	Moveable?:  true
BLOCK[17][14] Texture: whiteSquare.bmp	Moveable?:  true
BLOCK[17][15] Texture: whiteSquare.bmp	Moveable?:  true
BLOCK[17][16] Texture: blackSquare.bmp	Moveable?: *false
BLOCK[17][17] Texture: whiteSquare.bmp	Moveable?:  true
BLOCK[17][18] Texture: whiteSquare.bmp	Moveable?:  true
BLOCK[17][19] Texture: whiteSquare.bmp	Moveable?:  true
BLOCK[17][20] Texture: whiteSquare.bmp	Moveable?:  true
BLOCK[17][21] Texture: whiteSquare.bmp	Moveable?:  true
BLOCK[17][22] Texture: blackSquare.bmp	Moveable?: *false
BLOCK[17][23] Texture: whiteSquare.bmp	Moveable?:  true
BLOCK[17][24] Texture: whiteSquare.bmp	Moveable?:  true
BLOCK[17][25] Texture: whiteSquare.bmp	Moveable?:  true
BLOCK[17][26] Texture: blackSquare.bmp	Moveable?: *false
BLOCK[17][27] Texture: whiteSquare.bmp	Moveable?:  true
BLOCK[17][28] Texture: whiteSquare.bmp	Moveable?:  true
BLOCK[17][29] Texture: whiteSquare.bmp	Moveable?:  true
BLOCK[17][30] Texture: blackSquare.bmp	Moveable?: *false
BLOCK[17][31] Texture: whiteSquare.bmp	Moveable?:  true
BLOCK[17][32] Texture: whiteSquare.bmp	Moveable?:  true
BLOCK[17][33] Texture: whiteSquare.bmp	Moveable?:  true
BLOCK[17][34] Texture: whiteSquare.bmp	Moveable?:  true
BLOCK[17][35] Texture: whiteSquare.bmp	Moveable?:  true
BLOCK[17][36] Texture: whiteSquare.bmp	Moveable?:  true
BLOCK[17][37] Texture: whiteSquare.bmp	Moveable?:  true
BLOCK[17][38] Texture: whiteSquare.bmp	Moveable?:  true
BLOCK[17][39] Texture: whiteSquare.bmp	Moveable?:  true
BLOCK[17][40] Texture: blackSquare.bmp	Moveable?: *false
BLOCK[17][41] Texture: whiteSquare.bmp	Moveable?:  true
BLOCK[17][42] Texture: whiteSquare.bmp	Moveable?:  true
BLOCK[17][43] Texture: whiteSquare.bmp	Moveable?:  true
BLOCK[17][44] Texture: whiteSquare.bmp	Moveable?:  true
BLOCK[17][45] Texture: whiteSquare.bmp	Moveable?:  true
BLOCK[17][46] Texture: blackSquare.bmp	Moveable?: *false
BLOCK[17][47] Texture: whiteSquare.bmp	Moveable?:  true
BLOCK[17][48] Texture: blackSquare.bmp	Moveable?: *false
BLOCK[18][0] Texture: blackSquare.bmp	Moveable?: *false
BLOCK[18][1] Texture: whiteSquare.bmp	Moveable?:  true
BLOCK[18][2] Texture: blackSquare.bmp	Moveable?: *false
BLOCK[18][3] Texture: whiteSquare.bmp	Moveable?:  true
BLOCK[18][4] Texture: blackSquare.bmp	Moveable?: *false
BLOCK[18][5] Texture: whiteSquare.bmp	Moveable?:  true
BLOCK[18][6] Texture: blackSquare.bmp	Moveable?: *false
BLOCK[18][7] Texture: whiteSquare.bmp	Moveable?:  true
BLOCK[18][8] Texture: blackSquare.bmp	Moveable?: *false
BLOCK[18][9] Texture: whiteSquare.bmp	Moveable?:  true
BLOCK[18][10] Texture: blackSquare.bmp	Moveable?: *false
BLOCK[18][11] Texture: blackSquare.bmp	Moveable?: *false
BLOCK[18][12] Texture: blackSquare.bmp	Moveable?: *false
BLOCK[18][13] Texture: blackSquare.bmp	Moveable?: *false
BLOCK[18][14] Texture: blackSquare.bmp	Moveable?: *false
BLOCK[18][15] Texture: whiteSquare.bmp	Moveable?:  true
BLOCK[18][16] Texture: blackSquare.bmp	Moveable?: *false
BLOCK[18][17] Texture: whiteSquare.bmp	Moveable?:  true
BLOCK[18][18] Texture: blackSquare.bmp	Moveable?: *false
BLOCK[18][19] Texture: blackSquare.bmp	Moveable?: *false
BLOCK[18][20] Texture: blackSquare.bmp	Moveable?: *false
BLOCK[18][21] Texture: whiteSquare.bmp	Moveable?:  true
BLOCK[18][22] Texture: blackSquare.bmp	Moveable?: *false
BLOCK[18][23] Texture: blackSquare.bmp	Moveable?: *false
BLOCK[18][24] Texture: blackSquare.bmp	Moveable?: *false
BLOCK[18][25] Texture: whiteSquare.bmp	Moveable?:  true
BLOCK[18][26] Texture: blackSquare.bmp	Moveable?: *false
BLOCK[18][27] Texture: blackSquare.bmp	Moveable?: *false
BLOCK[18][28] Texture: blackSquare.bmp	Moveable?: *false
BLOCK[18][29] Texture: whiteSquare.bmp	Moveable?:  true
BLOCK[18][30] Texture: blackSquare.bmp	Moveable?: *false
BLOCK[18][31] Texture: blackSquare.bmp	Moveable?: *false
BLOCK[18][32] Texture: blackSquare.bmp	Moveable?: *false
BLOCK[18][33] Texture: blackSquare.bmp	Moveable?: *false
BLOCK[18][34] Texture: blackSquare.bmp	Moveable?: *false
BLOCK[18][35] Texture: blackSquare.bmp	Moveable?: *false
BLOCK[18][36] Texture: blackSquare.bmp	Moveable?: *false
BLOCK[18][37] Texture: blackSquare.bmp	Moveable?: *false
BLOCK[18][38] Texture: blackSquare.bmp	Moveable?: *false
BLOCK[18][39] Texture: blackSquare.bmp	Moveable?: *false
BLOCK[18][40] Texture: blackSquare.bmp	Moveable?: *false
BLOCK[18][41] Texture: whiteSquare.bmp	Moveable?:  true
BLOCK[18][42] Texture: blackSquare.bmp	Moveable?: *false
BLOCK[18][43] Texture: blackSquare.bmp	Moveable?: *false
BLOCK[18][44] Texture: blackSquare.bmp	Moveable?: *false
BLOCK[18][45] Texture: whiteSquare.bmp	Moveable?:  true
BLOCK[18][46] Texture: blackSquare.bmp	Moveable?: *false
BLOCK[18][47] Texture: whiteSquare.bmp	Moveable?:  true
BLOCK[18][48] Texture: blackSquare.bmp	Moveable?: *false
BLOCK[19][0] Texture: blackSquare.bmp	Moveable?: *false
BLOCK[19][1] Texture: whiteSquare.bmp	Moveable?:  true
BLOCK[19][2] Texture: blackSquare.bmp	Moveable?: *false
BLOCK[19][3] Texture: whiteSquare.bmp	Moveable?:  true
BLOCK[19][4] Texture: whiteSquare.bmp	Moveable?:  true
BLOCK[19][5] Texture: whiteSquare.bmp	Moveable?:  true
BLOCK[19][6] Texture: blackSquare.bmp	Moveable?: *false
BLOCK[19][7] Texture: whiteSquare.bmp	Moveable?:  true
BLOCK[19][8] Texture: whiteSquare.bmp	Moveable?:  true
BLOCK[19][9] Texture: whiteSquare.bmp	Moveable?:  true
BLOCK[19][10] Texture: blackSquare.bmp	Moveable?: *false
BLOCK[19][11] Texture: whiteSquare.bmp	Moveable?:  true
BLOCK[19][12] Texture: whiteSquare.bmp	Moveable?:  true
BLOCK[19][13] Texture: whiteSquare.bmp	Moveable?:  true
BLOCK[19][14] Texture: blackSquare.bmp	Moveable?: *false
BLOCK[19][15] Texture: whiteSquare.bmp	Moveable?:  true
BLOCK[19][16] Texture: blackSquare.bmp	Moveable?: *false
BLOCK[19][17] Texture: whiteSquare.bmp	Moveable?:  true
BLOCK[19][18] Texture: whiteSquare.bmp	Moveable?:  true
BLOCK[19][19] Texture: whiteSquare.bmp	Moveable?:  true
BLOCK[19][20] Texture: blackSquare.bmp	Moveable?: *false
BLOCK[19][21] Texture: whiteSquare.bmp	Moveable?:  true
BLOCK[19][22] Texture: blackSquare.bmp	Moveable?: *false
BLOCK[19][23] Texture: whiteSquare.bmp	Moveable?:  true
BLOCK[19][24] Texture: whiteSquare.bmp	Moveable?:  true
BLOCK[19][25] Texture: whiteSquare.bmp	Moveable?:  true
BLOCK[19][26] Texture: blackSquare.bmp	Moveable?: *false
BLOCK[19][27] Texture: whiteSquare.bmp	Moveable?:  true
BLOCK[19][28] Texture: blackSquare.bmp	Moveable?: *false
BLOCK[19][29] Texture: whiteSquare.bmp	Moveable?:  true
BLOCK[19][30] Texture: blackSquare.bmp	Moveable?: *false
BLOCK[19][31] Texture: whiteSquare.bmp	Moveable?:  true
BLOCK[19][32] Texture: whiteSquare.bmp	Moveable?:  true
BLOCK[19][33] Texture: whiteSquare.bmp	Moveable?:  true
BLOCK[19][34] Texture: whiteSquare.bmp	Moveable?:  true
BLOCK[19][35] Texture: whiteSquare.bmp	Moveable?:  true
BLOCK[19][36] Texture: whiteSquare.bmp	Moveable?:  true
BLOCK[19][37] Texture: whiteSquare.bmp	Moveable?:  true
BLOCK[19][38] Texture: whiteSquare.bmp	Moveable?:  true
BLOCK[19][39] Texture: whiteSquare.bmp	Moveable?:  true
BLOCK[19][40] Texture: whiteSquare.bmp	Moveable?:  true
BLOCK[19][41] Texture: whiteSquare.bmp	Moveable?:  true
BLOCK[19][42] Texture: blackSquare.bmp	Moveable?: *false
BLOCK[19][43] Texture: whiteSquare.bmp	Moveable?:  true
BLOCK[19][44] Texture: whiteSquare.bmp	Moveable?:  true
BLOCK[19][45] Texture: whiteSquare.bmp	Moveable?:  true
BLOCK[19][46] Texture: blackSquare.bmp	Moveable?: *false
BLOCK[19][47] Texture: whiteSquare.bmp	Moveable?:  true
BLOCK[19][48] Texture: blackSquare.bmp	Moveable?: *false
BLOCK[20][0] Texture: blackSquare.bmp	Moveable?: *false
BLOCK[20][1] Texture: whiteSquare.bmp	Moveable?:  true
BLOCK[20][2] Texture: blackSquare.bmp	Moveable?: *false
BLOCK[20][3] Texture: blackSquare.bmp	Moveable?: *false
BLOCK[20][4] Texture: blackSquare.bmp	Moveable?: *false
BLOCK[20][5] Texture: blackSquare.bmp	Moveable?: *false
BLOCK[20][6] Texture: blackSquare.bmp	Moveable?: *false
BLOCK[20][7] Texture: blackSquare.bmp	Moveable?: *false
BLOCK[20][8] Texture: blackSquare.bmp	Moveable?: *false
BLOCK[20][9] Texture: blackSquare.bmp	Moveable?: *false
BLOCK[20][10] Texture: blackSquare.bmp	Moveable?: *false
BLOCK[20][11] Texture: whiteSquare.bmp	Moveable?:  true
BLOCK[20][12] Texture: blackSquare.bmp	Moveable?: *false
BLOCK[20][13] Texture: whiteSquare.bmp	Moveable?:  true
BLOCK[20][14] Texture: blackSquare.bmp	Moveable?: *false
BLOCK[20][15] Texture: whiteSquare.bmp	Moveable?:  true
BLOCK[20][16] Texture: blackSquare.bmp	Moveable?: *false
BLOCK[20][17] Texture: whiteSquare.bmp	Moveable?:  true
BLOCK[20][18] Texture: blackSquare.bmp	Moveable?: *false
BLOCK[20][19] Texture: blackSquare.bmp	Moveable?: *false
BLOCK[20][20] Texture: blackSquare.bmp	Moveable?: *false
BLOCK[20][21] Texture: whiteSquare.bmp	Moveable?:  true
BLOCK[20][22] Texture: blackSquare.bmp	Moveable?: *false
BLOCK[20][23] Texture: whiteSquare.bmp	Moveable?:  true
BLOCK[20][24] Texture: blackSquare.bmp	Moveable?: *false
BLOCK[20][25] Texture: blackSquare.bmp	Moveable?: *false
BLOCK[20][26] Texture: blackSquare.bmp	Moveable?: *false
BLOCK[20][27] Texture: whiteSquare.bmp	Moveable?:  true
BLOCK[20][28] Texture: blackSquare.bmp	Moveable?: *false
BLOCK[20][29] Texture: whiteSquare.bmp	Moveable?:  true
BLOCK[20][30] Texture: blackSquare.bmp	Moveable?: *false
BLOCK[20][31] Texture: whiteSquare.bmp	Moveable?:  true
BLOCK[20][32] Texture: blackSquare.bmp	Moveable?: *false
BLOCK[20][33] Texture: blackSquare.bmp	Moveable?: *false
BLOCK[20][34] Texture: blackSquare.bmp	Moveable?: *false
BLOCK[20][35] Texture: blackSquare.bmp	Moveable?: *false
BLOCK[20][36] Texture: blackSquare.bmp	Moveable?: *false
BLOCK[20][37] Texture: blackSquare.bmp	Moveable?: *false
BLOCK[20][38] Texture: blackSquare.bmp	Moveable?: *false
BLOCK[20][39] Texture: blackSquare.bmp	Moveable?: *false
BLOCK[20][40] Texture: blackSquare.bmp	Moveable?: *false
BLOCK[20][41] Texture: blackSquare.bmp	Moveable?: *false
BLOCK[20][42] Texture: blackSquare.bmp	Moveable?: *false
BLOCK[20][43] Texture: whiteSquare.bmp	Moveable?:  true
BLOCK[20][44] Texture: blackSquare.bmp	Moveable?: *false
BLOCK[20][45] Texture: blackSquare.bmp	Moveable?: *false
BLOCK[20][46] Texture: blackSquare.bmp	Moveable?: *false
BLOCK[20][47] Texture: blackSquare.bmp	Moveable?: *false
BLOCK[20][48] Texture: blackSquare.bmp	Moveable?: *false
BLOCK[21][0] Texture: blackSquare.bmp	Moveable?: *false
BLOCK[21][1] Texture: whiteSquare.bmp	Moveable?:  true
BLOCK[21][2] Texture: whiteSquare.bmp	Moveable?:  true
BLOCK[21][3] Texture: whiteSquare.bmp	Moveable?:  true
BLOCK[21][4] Texture: whiteSquare.bmp	Moveable?:  true
BLOCK[21][5] Texture: whiteSquare.bmp	Moveable?:  true
BLOCK[21][6] Texture: blackSquare.bmp	Moveable?: *false
BLOCK[21][7] Texture: whiteSquare.bmp	Moveable?:  true
BLOCK[21][8] Texture: whiteSquare.bmp	Moveable?:  true
BLOCK[21][9] Texture: whiteSquare.bmp	Moveable?:  true
BLOCK[21][10] Texture: whiteSquare.bmp	Moveable?:  true
BLOCK[21][11] Texture: whiteSquare.bmp	Moveable?:  true
BLOCK[21][12] Texture: blackSquare.bmp	Moveable?: *false
BLOCK[21][13] Texture: whiteSquare.bmp	Moveable?:  true
BLOCK[21][14] Texture: blackSquare.bmp	Moveable?: *false
BLOCK[21][15] Texture: whiteSquare.bmp	Moveable?:  true
BLOCK[21][16] Texture: whiteSquare.bmp	Moveable?:  true
BLOCK[21][17] Texture: whiteSquare.bmp	Moveable?:  true
BLOCK[21][18] Texture: blackSquare.bmp	Moveable?: *false
BLOCK[21][19] Texture: whiteSquare.bmp	Moveable?:  true
BLOCK[21][20] Texture: whiteSquare.bmp	Moveable?:  true
BLOCK[21][21] Texture: whiteSquare.bmp	Moveable?:  true
BLOCK[21][22] Texture: blackSquare.bmp	Moveable?: *false
BLOCK[21][23] Texture: whiteSquare.bmp	Moveable?:  true
BLOCK[21][24] Texture: blackSquare.bmp	Moveable?: *false
BLOCK[21][25] Texture: whiteSquare.bmp	Moveable?:  true
BLOCK[21][26] Texture: whiteSquare.bmp	Moveable?:  true
BLOCK[21][27] Texture: whiteSquare.bmp	Moveable?:  true
BLOCK[21][28] Texture: blackSquare.bmp	Moveable?: *false
BLOCK[21][29] Texture: whiteSquare.bmp	Moveable?:  true
BLOCK[21][30] Texture: whiteSquare.bmp	Moveable?:  true
BLOCK[21][31] Texture: whiteSquare.bmp	Moveable?:  true
BLOCK[21][32] Texture: blackSquare.bmp	Moveable?: *false
BLOCK[21][33] Texture: whiteSquare.bmp	Moveable?:  true
BLOCK[21][34] Texture: whiteSquare.bmp	Moveable?:  true
BLOCK[21][35] Texture: whiteSquare.bmp	Moveable?:  true
BLOCK[21][36] Texture: whiteSquare.bmp	Moveable?:  true
BLOCK[21][37] Texture: whiteSquare.bmp	Moveable?:  true
BLOCK[21][38] Texture: whiteSquare.bmp	Moveable?:  true
BLOCK[21][39] Texture: whiteSquare.bmp	Moveable?:  true
BLOCK[21][40] Texture: blackSquare.bmp	Moveable?: *false
BLOCK[21][41] Texture: whiteSquare.bmp	Moveable?:  true
BLOCK[21][42] Texture: whiteSquare.bmp	Moveable?:  true
BLOCK[21][43] Texture: whiteSquare.bmp	Moveable?:  true
BLOCK[21][44] Texture: blackSquare.bmp	Moveable?: *false
BLOCK[21][45] Texture: whiteSquare.bmp	Moveable?:  true
BLOCK[21][46] Texture: whiteSquare.bmp	Moveable?:  true
BLOCK[21][47] Texture: whiteSquare.bmp	Moveable?:  true
BLOCK[21][48] Texture: blackSquare.bmp	Moveable?: *false
BLOCK[22][0] Texture: blackSquare.bmp	Moveable?: *false
BLOCK[22][1] Texture: blackSquare.bmp	Moveable?: *false
BLOCK[22][2] Texture: blackSquare.bmp	Moveable?: *false
BLOCK[22][3] Texture: blackSquare.bmp	Moveable?: *false
BLOCK[22][4] Texture: blackSquare.bmp	Moveable?: *false
BLOCK[22][5] Texture: blackSquare.bmp	Moveable?: *false
BLOCK[22][6] Texture: blackSquare.bmp	Moveable?: *false
BLOCK[22][7] Texture: whiteSquare.bmp	Moveable?:  true
BLOCK[22][8] Texture: blackSquare.bmp	Moveable?: *false
BLOCK[22][9] Texture: blackSquare.bmp	Moveable?: *false
BLOCK[22][10] Texture: blackSquare.bmp	Moveable?: *false
BLOCK[22][11] Texture: blackSquare.bmp	Moveable?: *false
BLOCK[22][12] Texture: blackSquare.bmp	Moveable?: *false
BLOCK[22][13] Texture: whiteSquare.bmp	Moveable?:  true
BLOCK[22][14] Texture: blackSquare.bmp	Moveable?: *false
BLOCK[22][15] Texture: blackSquare.bmp	Moveable?: *false
BLOCK[22][16] Texture: blackSquare.bmp	Moveable?: *false
BLOCK[22][17] Texture: whiteSquare.bmp	Moveable?:  true
BLOCK[22][18] Texture: blackSquare.bmp	Moveable?: *false
BLOCK[22][19] Texture: whiteSquare.bmp	Moveable?:  true
BLOCK[22][20] Texture: blackSquare.bmp	Moveable?: *false
BLOCK[22][21] Texture: blackSquare.bmp	Moveable?: *false
BLOCK[22][22] Texture: blackSquare.bmp	Moveable?: *false
BLOCK[22][23] Texture: whiteSquare.bmp	Moveable?:  true
BLOCK[22][24] Texture: blackSquare.bmp	Moveable?: *false
BLOCK[22][25] Texture: whiteSquare.bmp	Moveable?:  true
BLOCK[22][26] Texture: blackSquare.bmp	Moveable?: *false
BLOCK[22][27] Texture: whiteSquare.bmp	Moveable?:  true
BLOCK[22][28] Texture: blackSquare.bmp	Moveable?: *false
BLOCK[22][29] Texture: blackSquare.bmp	Moveable?: *false
BLOCK[22][30] Texture: blackSquare.bmp	Moveable?: *false
BLOCK[22][31] Texture: blackSquare.bmp	Moveable?: *false
BLOCK[22][32] Texture: blackSquare.bmp	Moveable?: *false
BLOCK[22][33] Texture: whiteSquare.bmp	Moveable?:  true
BLOCK[22][34] Texture: blackSquare.bmp	Moveable?: *false
BLOCK[22][35] Texture: blackSquare.bmp	Moveable?: *false
BLOCK[22][36] Texture: blackSquare.bmp	Moveable?: *false
BLOCK[22][37] Texture: blackSquare.bmp	Moveable?: *false
BLOCK[22][38] Texture: blackSquare.bmp	Moveable?: *false
BLOCK[22][39] Texture: whiteSquare.bmp	Moveable?:  true
BLOCK[22][40] Texture: blackSquare.bmp	Moveable?: *false
BLOCK[22][41] Texture: whiteSquare.bmp	Moveable?:  true
BLOCK[22][42] Texture: blackSquare.bmp	Moveable?: *false
BLOCK[22][43] Texture: blackSquare.bmp	Moveable?: *false
BLOCK[22][44] Texture: blackSquare.bmp	Moveable?: *false
BLOCK[22][45] Texture: whiteSquare.bmp	Moveable?:  true
BLOCK[22][46] Texture: blackSquare.bmp	Moveable?: *false
BLOCK[22][47] Texture: whiteSquare.bmp	Moveable?:  true
BLOCK[22][48] Texture: blackSquare.bmp	Moveable?: *false
BLOCK[23][0] Texture: blackSquare.bmp	Moveable?: *false
BLOCK[23][1] Texture: whiteSquare.bmp	Moveable?:  true
BLOCK[23][2] Texture: whiteSquare.bmp	Moveable?:  true
BLOCK[23][3] Texture: whiteSquare.bmp	Moveable?:  true
BLOCK[23][4] Texture: whiteSquare.bmp	Moveable?:  true
BLOCK[23][5] Texture: whiteSquare.bmp	Moveable?:  true
BLOCK[23][6] Texture: blackSquare.bmp	Moveable?: *false
BLOCK[23][7] Texture: whiteSquare.bmp	Moveable?:  true
BLOCK[23][8] Texture: whiteSquare.bmp	Moveable?:  true
BLOCK[23][9] Texture: whiteSquare.bmp	Moveable?:  true
BLOCK[23][10] Texture: whiteSquare.bmp	Moveable?:  true
BLOCK[23][11] Texture: whiteSquare.bmp	Moveable?:  true
BLOCK[23][12] Texture: blackSquare.bmp	Moveable?: *false
BLOCK[23][13] Texture: whiteSquare.bmp	Moveable?:  true
BLOCK[23][14] Texture: whiteSquare.bmp	Moveable?:  true
BLOCK[23][15] Texture: whiteSquare.bmp	Moveable?:  true
BLOCK[23][16] Texture: blackSquare.bmp	Moveable?: *false
BLOCK[23][17] Texture: whiteSquare.bmp	Moveable?:  true
BLOCK[23][18] Texture: blackSquare.bmp	Moveable?: *false
BLOCK[23][19] Texture: whiteSquare.bmp	Moveable?:  true
BLOCK[23][20] Texture: whiteSquare.bmp	Moveable?:  true
BLOCK[23][21] Texture: whiteSquare.bmp	Moveable?:  true
BLOCK[23][22] Texture: blackSquare.bmp	Moveable?: *false
BLOCK[23][23] Texture: whiteSquare.bmp	Moveable?:  true
BLOCK[23][24] Texture: whiteSquare.bmp	Moveable?:  true
BLOCK[23][25] Texture: whiteSquare.bmp	Moveable?:  true
BLOCK[23][26] Texture: blackSquare.bmp	Moveable?: *false
BLOCK[23][27] Texture: whiteSquare.bmp	Moveable?:  true
BLOCK[23][28] Texture: blackSquare.bmp	Moveable?: *false
BLOCK[23][29] Texture: whiteSquare.bmp	Moveable?:  true
BLOCK[23][30] Texture: whiteSquare.bmp	Moveable?:  true
BLOCK[23][31] Texture: whiteSquare.bmp	Moveable?:  true
BLOCK[23][32] Texture: blackSquare.bmp	Moveable?: *false
BLOCK[23][33] Texture: whiteSquare.bmp	Moveable?:  true
BLOCK[23][34] Texture: whiteSquare.bmp	Moveable?:  true
BLOCK[23][35] Texture: whiteSquare.bmp	Moveable?:  true
BLOCK[23][36] Texture: whiteSquare.bmp	Moveable?:  true
BLOCK[23][37] Texture: whiteSquare.bmp	Moveable?:  true
BLOCK[23][38] Texture: blackSquare.bmp	Moveable?: *false
BLOCK[23][39] Texture: whiteSquare.bmp	Moveable?:  true
BLOCK[23][40] Texture: blackSquare.bmp	Moveable?: *false
BLOCK[23][41] Texture: whiteSquare.bmp	Moveable?:  true
BLOCK[23][42] Texture: whiteSquare.bmp	Moveable?:  true
BLOCK[23][43] Texture: whiteSquare.bmp	Moveable?:  true
BLOCK[23][44] Texture: whiteSquare.bmp	Moveable?:  true
BLOCK[23][45] Texture: whiteSquare.bmp	Moveable?:  true
BLOCK[23][46] Texture: blackSquare.bmp	Moveable?: *false
BLOCK[23][47] Texture: whiteSquare.bmp	Moveable?:  true
BLOCK[23][48] Texture: blackSquare.bmp	Moveable?: *false
BLOCK[24][0] Texture: blackSquare.bmp	Moveable?: *false
BLOCK[24][1] Texture: whiteSquare.bmp	Moveable?:  true
BLOCK[24][2] Texture: blackSquare.bmp	Moveable?: *false
BLOCK[24][3] Texture: blackSquare.bmp	Moveable?: *false
BLOCK[24][4] Texture: blackSquare.bmp	Moveable?: *false
BLOCK[24][5] Texture: whiteSquare.bmp	Moveable?:  true
BLOCK[24][6] Texture: blackSquare.bmp	Moveable?: *false
BLOCK[24][7] Texture: blackSquare.bmp	Moveable?: *false
BLOCK[24][8] Texture: blackSquare.bmp	Moveable?: *false
BLOCK[24][9] Texture: blackSquare.bmp	Moveable?: *false
BLOCK[24][10] Texture: blackSquare.bmp	Moveable?: *false
BLOCK[24][11] Texture: whiteSquare.bmp	Moveable?:  true
BLOCK[24][12] Texture: blackSquare.bmp	Moveable?: *false
BLOCK[24][13] Texture: blackSquare.bmp	Moveable?: *false
BLOCK[24][14] Texture: blackSquare.bmp	Moveable?: *false
BLOCK[24][15] Texture: whiteSquare.bmp	Moveable?:  true
BLOCK[24][16] Texture: blackSquare.bmp	Moveable?: *false
BLOCK[24][17] Texture: blackSquare.bmp	Moveable?: *false
BLOCK[24][18] Texture: blackSquare.bmp	Moveable?: *false
BLOCK[24][19] Texture: blackSquare.bmp	Moveable?: *false
BLOCK[24][20] Texture: blackSquare.bmp	Moveable?: *false
BLOCK[24][21] Texture: whiteSquare.bmp	Moveable?:  true
BLOCK[24][22] Texture: blackSquare.bmp	Moveable?: *false
BLOCK[24][23] Texture: blackSquare.bmp	Moveable?: *false
BLOCK[24][24] Texture: blackSquare.bmp	Moveable?: *false
BLOCK[24][25] Texture: blackSquare.bmp	Moveable?: *false
BLOCK[24][26] Texture: blackSquare.bmp	Moveable?: *false
BLOCK[24][27] Texture: whiteSquare.bmp	Moveable?:  true
BLOCK[24][28] Texture: blackSquare.bmp	Moveable?: *false
BLOCK[24][29] Texture: blackSquare.bmp	Moveable?: *false
BLOCK[24][30] Texture: blackSquare.bmp	Moveable?: *false
BLOCK[24][31] Texture: whiteSquare.bmp	Moveable?:  true
BLOCK[24][32] Texture: blackSquare.bmp	Moveable?: *false
BLOCK[24][33] Texture: whiteSquare.bmp	Moveable?:  true
BLOCK[24][34] Texture: blackSquare.bmp	Moveable?: *false
BLOCK[24][35] Texture: blackSquare.bmp	Moveable?: *false
BLOCK[24][36] Texture: blackSquare.bmp	Moveable?: *false
BLOCK[24][37] Texture: whiteSquare.bmp	Moveable?:  true
BLOCK[24][38] Texture: blackSquare.bmp	Moveable?: *false
BLOCK[24][39] Texture: blackSquare.bmp	Moveable?: *false
BLOCK[24][40] Texture: blackSquare.bmp	Moveable?: *false
BLOCK[24][41] Texture: blackSquare.bmp	Moveable?: *false
BLOCK[24][42] Texture: blackSquare.bmp	Moveable?: *false
BLOCK[24][43] Texture: blackSquare.bmp	Moveable?: *false
BLOCK[24][44] Texture: blackSquare.bmp	Moveable?: *false
BLOCK[24][45] Texture: blackSquare.bmp	Moveable?: *false
BLOCK[24][46] Texture: blackSquare.bmp	Moveable?: *false
BLOCK[24][47] Texture: whiteSquare.bmp	Moveable?:  true
BLOCK[24][48] Texture: blackSquare.bmp	Moveable?: *false
BLOCK[25][0] Texture: blackSquare.bmp	Moveable?: *false
BLOCK[25][1] Texture: whiteSquare.bmp	Moveable?:  true
BLOCK[25][2] Texture: blackSquare.bmp	Moveable?: *false
BLOCK[25][3] Texture: whiteSquare.bmp	Moveable?:  true
BLOCK[25][4] Texture: whiteSquare.bmp	Moveable?:  true
BLOCK[25][5] Texture: whiteSquare.bmp	Moveable?:  true
BLOCK[25][6] Texture: whiteSquare.bmp	Moveable?:  true
BLOCK[25][7] Texture: whiteSquare.bmp	Moveable?:  true
BLOCK[25][8] Texture: blackSquare.bmp	Moveable?: *false
BLOCK[25][9] Texture: whiteSquare.bmp	Moveable?:  true
BLOCK[25][10] Texture: whiteSquare.bmp	Moveable?:  true
BLOCK[25][11] Texture: whiteSquare.bmp	Moveable?:  true
BLOCK[25][12] Texture: blackSquare.bmp	Moveable?: *false
BLOCK[25][13] Texture: whiteSquare.bmp	Moveable?:  true
BLOCK[25][14] Texture: blackSquare.bmp	Moveable?: *false
BLOCK[25][15] Texture: whiteSquare.bmp	Moveable?:  true
BLOCK[25][16] Texture: whiteSquare.bmp	Moveable?:  true
BLOCK[25][17] Texture: whiteSquare.bmp	Moveable?:  true
BLOCK[25][18] Texture: whiteSquare.bmp	Moveable?:  true
BLOCK[25][19] Texture: whiteSquare.bmp	Moveable?:  true
BLOCK[25][20] Texture: blackSquare.bmp	Moveable?: *false
BLOCK[25][21] Texture: whiteSquare.bmp	Moveable?:  true
BLOCK[25][22] Texture: whiteSquare.bmp	Moveable?:  true
BLOCK[25][23] Texture: whiteSquare.bmp	Moveable?:  true
BLOCK[25][24] Texture: blackSquare.bmp	Moveable?: *false
BLOCK[25][25] Texture: whiteSquare.bmp	Moveable?:  true
BLOCK[25][26] Texture: blackSquare.bmp	Moveable?: *false
BLOCK[25][27] Texture: whiteSquare.bmp	Moveable?:  true
BLOCK[25][28] Texture: whiteSquare.bmp	Moveable?:  true
BLOCK[25][29] Texture: whiteSquare.bmp	Moveable?:  true
BLOCK[25][30] Texture: blackSquare.bmp	Moveable?: *false
BLOCK[25][31] Texture: whiteSquare.bmp	Moveable?:  true
BLOCK[25][32] Texture: blackSquare.bmp	Moveable?: *false
BLOCK[25][33] Texture: whiteSquare.bmp	Moveable?:  true
BLOCK[25][34] Texture: blackSquare.bmp	Moveable?: *false
BLOCK[25][35] Texture: whiteSquare.bmp	Moveable?:  true
BLOCK[25][36] Texture: blackSquare.bmp	Moveable?: *false
BLOCK[25][37] Texture: whiteSquare.bmp	Moveable?:  true
BLOCK[25][38] Texture: whiteSquare.bmp	Moveable?:  true
BLOCK[25][39] Texture: whiteSquare.bmp	Moveable?:  true
BLOCK[25][40] Texture: whiteSquare.bmp	Moveable?:  true
BLOCK[25][41] Texture: whiteSquare.bmp	Moveable?:  true
BLOCK[25][42] Texture: blackSquare.bmp	Moveable?: *false
BLOCK[25][43] Texture: whiteSquare.bmp	Moveable?:  true
BLOCK[25][44] Texture: whiteSquare.bmp	Moveable?:  true
BLOCK[25][45] Texture: whiteSquare.bmp	Moveable?:  true
BLOCK[25][46] Texture: blackSquare.bmp	Moveable?: *false
BLOCK[25][47] Texture: whiteSquare.bmp	Moveable?:  true
BLOCK[25][48] Texture: blackSquare.bmp	Moveable?: *false
BLOCK[26][0] Texture: blackSquare.bmp	Moveable?: *false
BLOCK[26][1] Texture: whiteSquare.bmp	Moveable?:  true
BLOCK[26][2] Texture: blackSquare.bmp	Moveable?: *false
BLOCK[26][3] Texture: blackSquare.bmp	Moveable?: *false
BLOCK[26][4] Texture: blackSquare.bmp	Moveable?: *false
BLOCK[26][5] Texture: blackSquare.bmp	Moveable?: *false
BLOCK[26][6] Texture: blackSquare.bmp	Moveable?: *false
BLOCK[26][7] Texture: whiteSquare.bmp	Moveable?:  true
BLOCK[26][8] Texture: blackSquare.bmp	Moveable?: *false
BLOCK[26][9] Texture: whiteSquare.bmp	Moveable?:  true
BLOCK[26][10] Texture: blackSquare.bmp	Moveable?: *false
BLOCK[26][11] Texture: blackSquare.bmp	Moveable?: *false
BLOCK[26][12] Texture: blackSquare.bmp	Moveable?: *false
BLOCK[26][13] Texture: whiteSquare.bmp	Moveable?:  true
BLOCK[26][14] Texture: blackSquare.bmp	Moveable?: *false
BLOCK[26][15] Texture: blackSquare.bmp	Moveable?: *false
BLOCK[26][16] Texture: blackSquare.bmp	Moveable?: *false
BLOCK[26][17] Texture: blackSquare.bmp	Moveable?: *false
BLOCK[26][18] Texture: blackSquare.bmp	Moveable?: *false
BLOCK[26][19] Texture: whiteSquare.bmp	Moveable?:  true
BLOCK[26][20] Texture: blackSquare.bmp	Moveable?: *false
BLOCK[26][21] Texture: whiteSquare.bmp	Moveable?:  true
BLOCK[26][22] Texture: blackSquare.bmp	Moveable?: *false
BLOCK[26][23] Texture: whiteSquare.bmp	Moveable?:  true
BLOCK[26][24] Texture: blackSquare.bmp	Moveable?: *false
BLOCK[26][25] Texture: whiteSquare.bmp	Moveable?:  true
BLOCK[26][26] Texture: blackSquare.bmp	Moveable?: *false
BLOCK[26][27] Texture: blackSquare.bmp	Moveable?: *false
BLOCK[26][28] Texture: blackSquare.bmp	Moveable?: *false
BLOCK[26][29] Texture: whiteSquare.bmp	Moveable?:  true
BLOCK[26][30] Texture: blackSquare.bmp	Moveable?: *false
BLOCK[26][31] Texture: whiteSquare.bmp	Moveable?:  true
BLOCK[26][32] Texture: blackSquare.bmp	Moveable?: *false
BLOCK[26][33] Texture: whiteSquare.bmp	Moveable?:  true
BLOCK[26][34] Texture: blackSquare.bmp	Moveable?: *false
BLOCK[26][35] Texture: whiteSquare.bmp	Moveable?:  true
BLOCK[26][36] Texture: blackSquare.bmp	Moveable?: *false
BLOCK[26][37] Texture: blackSquare.bmp	Moveable?: *false
BLOCK[26][38] Texture: blackSquare.bmp	Moveable?: *false
BLOCK[26][39] Texture: whiteSquare.bmp	Moveable?:  true
BLOCK[26][40] Texture: blackSquare.bmp	Moveable?: *false
BLOCK[26][41] Texture: blackSquare.bmp	Moveable?: *false
BLOCK[26][42] Texture: blackSquare.bmp	Moveable?: *false
BLOCK[26][43] Texture: whiteSquare.bmp	Moveable?:  true
BLOCK[26][44] Texture: blackSquare.bmp	Moveable?: *false
BLOCK[26][45] Texture: whiteSquare.bmp	Moveable?:  true
BLOCK[26][46] Texture: blackSquare.bmp	Moveable?: *false
BLOCK[26][47] Texture: whiteSquare.bmp	Moveable?:  true
BLOCK[26][48] Texture: blackSquare.bmp	Moveable?: *false
BLOCK[27][0] Texture: blackSquare.bmp	Moveable?: *false
BLOCK[27][1] Texture: whiteSquare.bmp	Moveable?:  true
BLOCK[27][2] Texture: whiteSquare.bmp	Moveable?:  true
BLOCK[27][3] Texture: whiteSquare.bmp	Moveable?:  true
BLOCK[27][4] Texture: whiteSquare.bmp	Moveable?:  true
BLOCK[27][5] Texture: whiteSquare.bmp	Moveable?:  true
BLOCK[27][6] Texture: blackSquare.bmp	Moveable?: *false
BLOCK[27][7] Texture: whiteSquare.bmp	Moveable?:  true
BLOCK[27][8] Texture: whiteSquare.bmp	Moveable?:  true
BLOCK[27][9] Texture: whiteSquare.bmp	Moveable?:  true
BLOCK[27][10] Texture: blackSquare.bmp	Moveable?: *false
BLOCK[27][11] Texture: whiteSquare.bmp	Moveable?:  true
BLOCK[27][12] Texture: whiteSquare.bmp	Moveable?:  true
BLOCK[27][13] Texture: whiteSquare.bmp	Moveable?:  true
BLOCK[27][14] Texture: whiteSquare.bmp	Moveable?:  true
BLOCK[27][15] Texture: whiteSquare.bmp	Moveable?:  true
BLOCK[27][16] Texture: whiteSquare.bmp	Moveable?:  true
BLOCK[27][17] Texture: whiteSquare.bmp	Moveable?:  true
BLOCK[27][18] Texture: blackSquare.bmp	Moveable?: *false
BLOCK[27][19] Texture: whiteSquare.bmp	Moveable?:  true
BLOCK[27][20] Texture: whiteSquare.bmp	Moveable?:  true
BLOCK[27][21] Texture: whiteSquare.bmp	Moveable?:  true
BLOCK[27][22] Texture: blackSquare.bmp	Moveable?: *false
BLOCK[27][23] Texture: whiteSquare.bmp	Moveable?:  true
BLOCK[27][24] Texture: blackSquare.bmp	Moveable?: *false
BLOCK[27][25] Texture: whiteSquare.bmp	Moveable?:  true
BLOCK[27][26] Texture: whiteSquare.bmp	Moveable?:  true
BLOCK[27][27] Texture: whiteSquare.bmp	Moveable?:  true
BLOCK[27][28] Texture: blackSquare.bmp	Moveable?: *false
BLOCK[27][29] Texture: whiteSquare.bmp	Moveable?:  true
BLOCK[27][30] Texture: blackSquare.bmp	Moveable?: *false
BLOCK[27][31] Texture: whiteSquare.bmp	Moveable?:  true
BLOCK[27][32] Texture: whiteSquare.bmp	Moveable?:  true
BLOCK[27][33] Texture: whiteSquare.bmp	Moveable?:  true
BLOCK[27][34] Texture: whiteSquare.bmp	Moveable?:  true
BLOCK[27][35] Texture: whiteSquare.bmp	Moveable?:  true
BLOCK[27][36] Texture: whiteSquare.bmp	Moveable?:  true
BLOCK[27][37] Texture: whiteSquare.bmp	Moveable?:  true
BLOCK[27][38] Texture: blackSquare.bmp	Moveable?: *false
BLOCK[27][39] Texture: whiteSquare.bmp	Moveable?:  true
BLOCK[27][40] Texture: blackSquare.bmp	Moveable?: *false
BLOCK[27][41] Texture: whiteSquare.bmp	Moveable?:  true
BLOCK[27][42] Texture: whiteSquare.bmp	Moveable?:  true
BLOCK[27][43] Texture: whiteSquare.bmp	Moveable?:  true
BLOCK[27][44] Texture: blackSquare.bmp	Moveable?: *false
BLOCK[27][45] Texture: whiteSquare.bmp	Moveable?:  true
BLOCK[27][46] Texture: whiteSquare.bmp	Moveable?:  true
BLOCK[27][47] Texture: whiteSquare.bmp	Moveable?:  true
BLOCK[27][48] Texture: blackSquare.bmp	Moveable?: *false
BLOCK[28][0] Texture: blackSquare.bmp	Moveable?: *false
BLOCK[28][1] Texture: whiteSquare.bmp	Moveable?:  true
BLOCK[28][2] Texture: blackSquare.bmp	Moveable?: *false
BLOCK[28][3] Texture: blackSquare.bmp	Moveable?: *false
BLOCK[28][4] Texture: blackSquare.bmp	Moveable?: *false
BLOCK[28][5] Texture: whiteSquare.bmp	Moveable?:  true
BLOCK[28][6] Texture: blackSquare.bmp	Moveable?: *false
BLOCK[28][7] Texture: blackSquare.bmp	Moveable?: *false
BLOCK[28][8] Texture: blackSquare.bmp	Moveable?: *false
BLOCK[28][9] Texture: blackSquare.bmp	Moveable?: *false
BLOCK[28][10] Texture: blackSquare.bmp	Moveable?: *false
BLOCK[28][11] Texture: whiteSquare.bmp	Moveable?:  true
BLOCK[28][12] Texture: blackSquare.bmp	Moveable?: *false
BLOCK[28][13] Texture: blackSquare.bmp	Moveable?: *false
BLOCK[28][14] Texture: blackSquare.bmp	Moveable?: *false
BLOCK[28][15] Texture: blackSquare.bmp	Moveable?: *false
BLOCK[28][16] Texture: blackSquare.bmp	Moveable?: *false
BLOCK[28][17] Texture: whiteSquare.bmp	Moveable?:  true
BLOCK[28][18] Texture: blackSquare.bmp	Moveable?: *false
BLOCK[28][19] Texture: blackSquare.bmp	Moveable?: *false
BLOCK[28][20] Texture: blackSquare.bmp	Moveable?: *false
BLOCK[28][21] Texture: blackSquare.bmp	Moveable?: *false
BLOCK[28][22] Texture: blackSquare.bmp	Moveable?: *false
BLOCK[28][23] Texture: whiteSquare.bmp	Moveable?:  true
BLOCK[28][24] Texture: blackSquare.bmp	Moveable?: *false
BLOCK[28][25] Texture: blackSquare.bmp	Moveable?: *false
BLOCK[28][26] Texture: blackSquare.bmp	Moveable?: *false
BLOCK[28][27] Texture: whiteSquare.bmp	Moveable?:  true
BLOCK[28][28] Texture: blackSquare.bmp	Moveable?: *false
BLOCK[28][29] Texture: whiteSquare.bmp	Moveable?:  true
BLOCK[28][30] Texture: blackSquare.bmp	Moveable?: *false
BLOCK[28][31] Texture: blackSquare.bmp	Moveable?: *false
BLOCK[28][32] Texture: blackSquare.bmp	Moveable?: *false
BLOCK[28][33] Texture: blackSquare.bmp	Moveable?: *false
BLOCK[28][34] Texture: blackSquare.bmp	Moveable?: *false
BLOCK[28][35] Texture: blackSquare.bmp	Moveable?: *false
BLOCK[28][36] Texture: blackSquare.bmp	Moveable?: *false
BLOCK[28][37] Texture: blackSquare.bmp	Moveable?: *false
BLOCK[28][38] Texture: blackSquare.bmp	Moveable?: *false
BLOCK[28][39] Texture: whiteSquare.bmp	Moveable?:  true
BLOCK[28][40] Texture: blackSquare.bmp	Moveable?: *false
BLOCK[28][41] Texture: whiteSquare.bmp	Moveable?:  true
BLOCK[28][42] Texture: blackSquare.bmp	Moveable?: *false
BLOCK[28][43] Texture: blackSquare.bmp	Moveable?: *false
BLOCK[28][44] Texture: blackSquare.bmp	Moveable?: *false
BLOCK[28][45] Texture: blackSquare.bmp	Moveable?: *false
BLOCK[28][46] Texture: blackSquare.bmp	Moveable?: *false
BLOCK[28][47] Texture: blackSquare.bmp	Moveable?: *false
BLOCK[28][48] Texture: blackSquare.bmp	Moveable?: *false
BLOCK[29][0] Texture: blackSquare.bmp	Moveable?: *false
BLOCK[29][1] Texture: whiteSquare.bmp	Moveable?:  true
BLOCK[29][2] Texture: blackSquare.bmp	Moveable?: *false
BLOCK[29][3] Texture: whiteSquare.bmp	Moveable?:  true
BLOCK[29][4] Texture: whiteSquare.bmp	Moveable?:  true
BLOCK[29][5] Texture: whiteSquare.bmp	Moveable?:  true
BLOCK[29][6] Texture: blackSquare.bmp	Moveable?: *false
BLOCK[29][7] Texture: whiteSquare.bmp	Moveable?:  true
BLOCK[29][8] Texture: whiteSquare.bmp	Moveable?:  true
BLOCK[29][9] Texture: whiteSquare.bmp	Moveable?:  true
BLOCK[29][10] Texture: whiteSquare.bmp	Moveable?:  true
BLOCK[29][11] Texture: whiteSquare.bmp	Moveable?:  true
BLOCK[29][12] Texture: whiteSquare.bmp	Moveable?:  true
BLOCK[29][13] Texture: whiteSquare.bmp	Moveable?:  true
BLOCK[29][14] Texture: blackSquare.bmp	Moveable?: *false
BLOCK[29][15] Texture: whiteSquare.bmp	Moveable?:  true
BLOCK[29][16] Texture: whiteSquare.bmp	Moveable?:  true
BLOCK[29][17] Texture: whiteSquare.bmp	Moveable?:  true
BLOCK[29][18] Texture: whiteSquare.bmp	Moveable?:  true
BLOCK[29][19] Texture: whiteSquare.bmp	Moveable?:  true
BLOCK[29][20] Texture: blackSquare.bmp	Moveable?: *false
BLOCK[29][21] Texture: whiteSquare.bmp	Moveable?:  true
BLOCK[29][22] Texture: whiteSquare.bmp	Moveable?:  true
BLOCK[29][23] Texture: whiteSquare.bmp	Moveable?:  true
BLOCK[29][24] Texture: blackSquare.bmp	Moveable?: *false
BLOCK[29][25] Texture: whiteSquare.bmp	Moveable?:  true
BLOCK[29][26] Texture: whiteSquare.bmp	Moveable?:  true
BLOCK[29][27] Texture: whiteSquare.bmp	Moveable?:  true
BLOCK[29][28] Texture: blackSquare.bmp	Moveable?: *false
BLOCK[29][29] Texture: whiteSquare.bmp	Moveable?:  true
BLOCK[29][30] Texture: whiteSquare.bmp	Moveable?:  true
BLOCK[29][31] Texture: whiteSquare.bmp	Moveable?:  true
BLOCK[29][32] Texture: whiteSquare.bmp	Moveable?:  true
BLOCK[29][33] Texture: whiteSquare.bmp	Moveable?:  true
BLOCK[29][34] Texture: blackSquare.bmp	Moveable?: *false
BLOCK[29][35] Texture: whiteSquare.bmp	Moveable?:  true
BLOCK[29][36] Texture: whiteSquare.bmp	Moveable?:  true
BLOCK[29][37] Texture: whiteSquare.bmp	Moveable?:  true
BLOCK[29][38] Texture: whiteSquare.bmp	Moveable?:  true
BLOCK[29][39] Texture: whiteSquare.bmp	Moveable?:  true
BLOCK[29][40] Texture: blackSquare.bmp	Moveable?: *false
BLOCK[29][41] Texture: whiteSquare.bmp	Moveable?:  true
BLOCK[29][42] Texture: whiteSquare.bmp	Moveable?:  true
BLOCK[29][43] Texture: whiteSquare.bmp	Moveable?:  true
BLOCK[29][44] Texture: whiteSquare.bmp	Moveable?:  true
BLOCK[29][45] Texture: whiteSquare.bmp	Moveable?: Strue
BLOCK[29][46] Texture: blackSquare.bmp	Moveable?: *false
BLOCK[29][47] Texture: whiteSquare.bmp	Moveable?:  true
BLOCK[29][48] Texture: blackSquare.bmp	Moveable?: *false
BLOCK[30][0] Texture: blackSquare.bmp	Moveable?: *false
BLOCK[30][1] Texture: whiteSquare.bmp	Moveable?:  true
BLOCK[30][2] Texture: blackSquare.bmp	Moveable?: *false
BLOCK[30][3] Texture: whiteSquare.bmp	Moveable?:  true
BLOCK[30][4] Texture: blackSquare.bmp	Moveable?: *false
BLOCK[30][5] Texture: blackSquare.bmp	Moveable?: *false
BLOCK[30][6] Texture: blackSquare.bmp	Moveable?: *false
BLOCK[30][7] Texture: whiteSquare.bmp	Moveable?:  true
BLOCK[30][8] Texture: blackSquare.bmp	Moveable?: *false
BLOCK[30][9] Texture: blackSquare.bmp	Moveable?: *false
BLOCK[30][10] Texture: blackSquare.bmp	Moveable?: *false
BLOCK[30][11] Texture: blackSquare.bmp	Moveable?: *false
BLOCK[30][12] Texture: blackSquare.bmp	Moveable?: *false
BLOCK[30][13] Texture: whiteSquare.bmp	Moveable?:  true
BLOCK[30][14] Texture: blackSquare.bmp	Moveable?: *false
BLOCK[30][15] Texture: blackSquare.bmp	Moveable?: *false
BLOCK[30][16] Texture: blackSquare.bmp	Moveable?: *false
BLOCK[30][17] Texture: blackSquare.bmp	Moveable?: *false
BLOCK[30][18] Texture: blackSquare.bmp	Moveable?: *false
BLOCK[30][19] Texture: whiteSquare.bmp	Moveable?:  true
BLOCK[30][20] Texture: blackSquare.bmp	Moveable?: *false
BLOCK[30][21] Texture: whiteSquare.bmp	Moveable?:  true
BLOCK[30][22] Texture: blackSquare.bmp	Moveable?: *false
BLOCK[30][23] Texture: blackSquare.bmp	Moveable?: *false
BLOCK[30][24] Texture: blackSquare.bmp	Moveable?: *false
BLOCK[30][25] Texture: whiteSquare.bmp	Moveable?:  true
BLOCK[30][26] Texture: blackSquare.bmp	Moveable?: *false
BLOCK[30][27] Texture: whiteSquare.bmp	Moveable?:  true
BLOCK[30][28] Texture: blackSquare.bmp	Moveable?: *false
BLOCK[30][29] Texture: blackSquare.bmp	Moveable?: *false
BLOCK[30][30] Texture: blackSquare.bmp	Moveable?: *false
BLOCK[30][31] Texture: blackSquare.bmp	Moveable?: *false
BLOCK[30][32] Texture: blackSquare.bmp	Moveable?: *false
BLOCK[30][33] Texture: whiteSquare.bmp	Moveable?:  true
BLOCK[30][34] Texture: blackSquare.bmp	Moveable?: *false
BLOCK[30][35] Texture: whiteSquare.bmp	Moveable?:  true
BLOCK[30][36] Texture: blackSquare.bmp	Moveable?: *false
BLOCK[30][37] Texture: blackSquare.bmp	Moveable?: *false
BLOCK[30][38] Texture: blackSquare.bmp	Moveable?: *false
BLOCK[30][39] Texture: whiteSquare.bmp	Moveable?:  true
BLOCK[30][40] Texture: blackSquare.bmp	Moveable?: *false
BLOCK[30][41] Texture: blackSquare.bmp	Moveable?: *false
BLOCK[30][42] Texture: blackSquare.bmp	Moveable?: *false
BLOCK[30][43] Texture: blackSquare.bmp	Moveable?: *false
BLOCK[30][44] Texture: blackSquare.bmp	Moveable?: *false
BLOCK[30][45] Texture: blackSquare.bmp	Moveable?: *false
BLOCK[30][46] Texture: blackSquare.bmp	Moveable?: *false
BLOCK[30][47] Texture: whiteSquare.bmp	Moveable?:  true
BLOCK[30][48] Texture: blackSquare.bmp	Moveable?: *false
BLOCK[31][0] Texture: blackSquare.bmp	Moveable?: *false
BLOCK[31][1] Texture: whiteSquare.bmp	Moveable?:  true
BLOCK[31][2] Texture: blackSquare.bmp	Moveable?: *false
BLOCK[31][3] Texture: whiteSquare.bmp	Moveable?:  true
BLOCK[31][4] Texture: blackSquare.bmp	Moveable?: *false
BLOCK[31][5] Texture: whiteSquare.bmp	Moveable?:  true
BLOCK[31][6] Texture: blackSquare.bmp	Moveable?: *false
BLOCK[31][7] Texture: whiteSquare.bmp	Moveable?:  true
BLOCK[31][8] Texture: whiteSquare.bmp	Moveable?:  true
BLOCK[31][9] Texture: whiteSquare.bmp	Moveable?:  true
BLOCK[31][10] Texture: whiteSquare.bmp	Moveable?:  true
BLOCK[31][11] Texture: whiteSquare.bmp	Moveable?:  true
BLOCK[31][12] Texture: blackSquare.bmp	Moveable?: *false
BLOCK[31][13] Texture: whiteSquare.bmp	Moveable?:  true
BLOCK[31][14] Texture: whiteSquare.bmp	Moveable?:  true
BLOCK[31][15] Texture: whiteSquare.bmp	Moveable?:  true
BLOCK[31][16] Texture: whiteSquare.bmp	Moveable?:  true
BLOCK[31][17] Texture: whiteSquare.bmp	Moveable?:  true
BLOCK[31][18] Texture: blackSquare.bmp	Moveable?: *false
BLOCK[31][19] Texture: whiteSquare.bmp	Moveable?:  true
BLOCK[31][20] Texture: blackSquare.bmp	Moveable?: *false
BLOCK[31][21] Texture: whiteSquare.bmp	Moveable?:  true
BLOCK[31][22] Texture: whiteSquare.bmp	Moveable?:  true
BLOCK[31][23] Texture: whiteSquare.bmp	Moveable?:  true
BLOCK[31][24] Texture: blackSquare.bmp	Moveable?: *false
BLOCK[31][25] Texture: whiteSquare.bmp	Moveable?:  true
BLOCK[31][26] Texture: blackSquare.bmp	Moveable?: *false
BLOCK[31][27] Texture: whiteSquare.bmp	Moveable?:  true
BLOCK[31][28] Texture: blackSquare.bmp	Moveable?: *false
BLOCK[31][29] Texture: whiteSquare.bmp	Moveable?:  true
BLOCK[31][30] Texture: whiteSquare.bmp	Moveable?:  true
BLOCK[31][31] Texture: whiteSquare.bmp	Moveable?:  true
BLOCK[31][32] Texture: whiteSquare.bmp	Moveable?:  true
BLOCK[31][33] Texture: whiteSquare.bmp	Moveable?:  true
BLOCK[31][34] Texture: blackSquare.bmp	Moveable?: *false
BLOCK[31][35] Texture: whiteSquare.bmp	Moveable?:  true
BLOCK[31][36] Texture: blackSquare.bmp	Moveable?: *false
BLOCK[31][37] Texture: whiteSquare.bmp	Moveable?:  true
BLOCK[31][38] Texture: whiteSquare.bmp	Moveable?:  true
BLOCK[31][39] Texture: whiteSquare.bmp	Moveable?:  true
BLOCK[31][40] Texture: blackSquare.bmp	Moveable?: *false
BLOCK[31][41] Texture: whiteSquare.bmp	Moveable?:  true
BLOCK[31][42] Texture: whiteSquare.bmp	Moveable?:  true
BLOCK[31][43] Texture: whiteSquare.bmp	Moveable?:  true
BLOCK[31][44] Texture: blackSquare.bmp	Moveable?: *false
BLOCK[31][45] Texture: whiteSquare.bmp	Moveable?:  true
BLOCK[31][46] Texture: whiteSquare.bmp	Moveable?:  true
BLOCK[31][47] Texture: whiteSquare.bmp	Moveable?:  true
BLOCK[31][48] Texture: blackSquare.bmp	Moveable?: *false
BLOCK[32][0] Texture: blackSquare.bmp	Moveable?: *false
BLOCK[32][1] Texture: whiteSquare.bmp	Moveable?:  true
BLOCK[32][2] Texture: blackSquare.bmp	Moveable?: *false
BLOCK[32][3] Texture: whiteSquare.bmp	Moveable?:  true
BLOCK[32][4] Texture: blackSquare.bmp	Moveable?: *false
BLOCK[32][5] Texture: whiteSquare.bmp	Moveable?:  true
BLOCK[32][6] Texture: blackSquare.bmp	Moveable?: *false
BLOCK[32][7] Texture: blackSquare.bmp	Moveable?: *false
BLOCK[32][8] Texture: blackSquare.bmp	Moveable?: *false
BLOCK[32][9] Texture: blackSquare.bmp	Moveable?: *false
BLOCK[32][10] Texture: blackSquare.bmp	Moveable?: *false
BLOCK[32][11] Texture: whiteSquare.bmp	Moveable?:  true
BLOCK[32][12] Texture: blackSquare.bmp	Moveable?: *false
BLOCK[32][13] Texture: blackSquare.bmp	Moveable?: *false
BLOCK[32][14] Texture: blackSquare.bmp	Moveable?: *false
BLOCK[32][15] Texture: blackSquare.bmp	Moveable?: *false
BLOCK[32][16] Texture: blackSquare.bmp	Moveable?: *false
BLOCK[32][17] Texture: whiteSquare.bmp	Moveable?:  true
BLOCK[32][18] Texture: blackSquare.bmp	Moveable?: *false
BLOCK[32][19] Texture: blackSquare.bmp	Moveable?: *false
BLOCK[32][20] Texture: blackSquare.bmp	Moveable?: *false
BLOCK[32][21] Texture: blackSquare.bmp	Moveable?: *false
BLOCK[32][22] Texture: blackSquare.bmp	Moveable?: *false
BLOCK[32][23] Texture: whiteSquare.bmp	Moveable?:  true
BLOCK[32][24] Texture: blackSquare.bmp	Moveable?: *false
BLOCK[32][25] Texture: whiteSquare.bmp	Moveable?:  true
BLOCK[32][26] Texture: blackSquare.bmp	Moveable?: *false
BLOCK[32][27] Texture: blackSquare.bmp	Moveable?: *false
BLOCK[32][28] Texture: blackSquare.bmp	Moveable?: *false
BLOCK[32][29] Texture: whiteSquare.bmp	Moveable?:  true
BLOCK[32][30] Texture: blackSquare.bmp	Moveable?: *false
BLOCK[32][31] Texture: blackSquare.bmp	Moveable?: *false
BLOCK[32][32] Texture: blackSquare.bmp	Moveable?: *false
BLOCK[32][33] Texture: blackSquare.bmp	Moveable?: *false
BLOCK[32][34] Texture: blackSquare.bmp	Moveable?: *false
BLOCK[32][35] Texture: whiteSquare.bmp	Moveable?:  true
BLOCK[32][36] Texture: blackSquare.bmp	Moveable?: *false
BLOCK[32][37] Texture: whiteSquare.bmp	Moveable?:  true
BLOCK[32][38] Texture: blackSquare.bmp	Moveable?: *false
BLOCK[32][39] Texture: blackSquare.bmp	Moveable?: *false
BLOCK[32][40] Texture: blackSquare.bmp	Moveable?: *false
BLOCK[32][41] Texture: whiteSquare.bmp	Moveable?:  true
BLOCK[32][42] Texture: blackSquare.bmp	Moveable?: *false
BLOCK[32][43] Texture: whiteSquare.bmp	Moveable?:  true
BLOCK[32][44] Texture: blackSquare.bmp	Moveable?: *false
BLOCK[32][45] Texture: whiteSquare.bmp	Moveable?:  true
BLOCK[32][46] Texture: blackSquare.bmp	Moveable?: *false
BLOCK[32][47] Texture: whiteSquare.bmp	Moveable?:  true
BLOCK[32][48] Texture: blackSquare.bmp	Moveable?: *false
BLOCK[33][0] Texture: blackSquare.bmp	Moveable?: *false
BLOCK[33][1] Texture: whiteSquare.bmp	Moveable?:  true
BLOCK[33][2] Texture: blackSquare.bmp	Moveable?: *false
BLOCK[33][3] Texture: whiteSquare.bmp	Moveable?:  true
BLOCK[33][4] Texture: blackSquare.bmp	Moveable?: *false
BLOCK[33][5] Texture: whiteSquare.bmp	Moveable?:  true
BLOCK[33][6] Texture: blackSquare.bmp	Moveable?: *false
BLOCK[33][7] Texture: whiteSquare.bmp	Moveable?:  true
BLOCK[33][8] Texture: whiteSquare.bmp	Moveable?:  true
BLOCK[33][9] Texture: whiteSquare.bmp	Moveable?:  true
BLOCK[33][10] Texture: whiteSquare.bmp	Moveable?:  true
BLOCK[33][11] Texture: whiteSquare.bmp	Moveable?:  true
BLOCK[33][12] Texture: blackSquare.bmp	Moveable?: *false
BLOCK[33][13] Texture: whiteSquare.bmp	Moveable?:  true
BLOCK[33][14] Texture: blackSquare.bmp	Moveable?: *false
BLOCK[33][15] Texture: whiteSquare.bmp	Moveable?:  true
BLOCK[33][16] Texture: whiteSquare.bmp	Moveable?:  true
BLOCK[33][17] Texture: whiteSquare.bmp	Moveable?:  true
BLOCK[33][18] Texture: blackSquare.bmp	Moveable?: *false
BLOCK[33][19] Texture: whiteSquare.bmp	Moveable?:  true
BLOCK[33][20] Texture: whiteSquare.bmp	Moveable?:  true
BLOCK[33][21] Texture: whiteSquare.bmp	Moveable?:  true
BLOCK[33][22] Texture: whiteSquare.bmp	Moveable?:  true
BLOCK[33][23] Texture: whiteSquare.bmp	Moveable?:  true
BLOCK[33][24] Texture: blackSquare.bmp	Moveable?: *false
BLOCK[33][25] Texture: whiteSquare.bmp	Moveable?:  true
BLOCK[33][26] Texture: blackSquare.bmp	Moveable?: *false
BLOCK[33][27] Texture: whiteSquare.bmp	Moveable?:  true
BLOCK[33][28] Texture: whiteSquare.bmp	Moveable?:  true
BLOCK[33][29] Texture: whiteSquare.bmp	Moveable?:  true
BLOCK[33][30] Texture: blackSquare.bmp	Moveable?: *false
BLOCK[33][31] Texture: whiteSquare.bmp	Moveable?:  true
BLOCK[33][32] Texture: whiteSquare.bmp	Moveable?:  true
BLOCK[33][33] Texture: whiteSquare.bmp	Moveable?:  true
BLOCK[33][34] Texture: whiteSquare.bmp	Moveable?:  true
BLOCK[33][35] Texture: whiteSquare.bmp	Moveable?:  true
BLOCK[33][36] Texture: blackSquare.bmp	Moveable?: *false
BLOCK[33][37] Texture: whiteSquare.bmp	Moveable?:  true
BLOCK[33][38] Texture: whiteSquare.bmp	Moveable?:  true
BLOCK[33][39] Texture: whiteSquare.bmp	Moveable?:  true
BLOCK[33][40] Texture: whiteSquare.bmp	Moveable?:  true
BLOCK[33][41] Texture: whiteSquare.bmp	Moveable?:  true
BLOCK[33][42] Texture: blackSquare.bmp	Moveable?: *false
BLOCK[33][43] Texture: whiteSquare.bmp	Moveable?:  true
BLOCK[33][44] Texture: whiteSquare.bmp	Moveable?:  true
BLOCK[33][45] Texture: whiteSquare.bmp	Moveable?:  true
BLOCK[33][46] Texture: blackSquare.bmp	Moveable?: *false
BLOCK[33][47] Texture: whiteSquare.bmp	Moveable?:  true
BLOCK[33][48] Texture: blackSquare.bmp	Moveable?: *false
BLOCK[34][0] Texture: blackSquare.bmp	Moveable?: *false
BLOCK[34][1] Texture: whiteSquare.bmp	Moveable?:  true
BLOCK[34][2] Texture: blackSquare.bmp	Moveable?: *false
BLOCK[34][3] Texture: whiteSquare.bmp	Moveable?:  true
BLOCK[34][4] Texture: blackSquare.bmp	Moveable?: *false
BLOCK[34][5] Texture: whiteSquare.bmp	Moveable?:  true
BLOCK[34][6] Texture: blackSquare.bmp	Moveable?: *false
BLOCK[34][7] Texture: whiteSquare.bmp	Moveable?:  true
BLOCK[34][8] Texture: blackSquare.bmp	Moveable?: *false
BLOCK[34][9] Texture: blackSquare.bmp	Moveable?: *false
BLOCK[34][10] Texture: blackSquare.bmp	Moveable?: *false
BLOCK[34][11] Texture: blackSquare.bmp	Moveable?: *false
BLOCK[34][12] Texture: blackSquare.bmp	Moveable?: *false
BLOCK[34][13] Texture: whiteSquare.bmp	Moveable?:  true
BLOCK[34][14] Texture: blackSquare.bmp	Moveable?: *false
BLOCK[34][15] Texture: whiteSquare.bmp	Moveable?:  true
BLOCK[34][16] Texture: blackSquare.bmp	Moveable?: *false
BLOCK[34][17] Texture: whiteSquare.bmp	Moveable?:  true
BLOCK[34][18] Texture: blackSquare.bmp	Moveable?: *false
BLOCK[34][19] Texture: whiteSquare.bmp	Moveable?:  true
BLOCK[34][20] Texture: blackSquare.bmp	Moveable?: *false
BLOCK[34][21] Texture: blackSquare.bmp	Moveable?: *false
BLOCK[34][22] Texture: blackSquare.bmp	Moveable?: *false
BLOCK[34][23] Texture: blackSquare.bmp	Moveable?: *false
BLOCK[34][24] Texture: blackSquare.bmp	Moveable?: *false
BLOCK[34][25] Texture: whiteSquare.bmp	Moveable?:  true
BLOCK[34][26] Texture: blackSquare.bmp	Moveable?: *false
BLOCK[34][27] Texture: whiteSquare.bmp	Moveable?:  true
BLOCK[34][28] Texture: blackSquare.bmp	Moveable?: *false
BLOCK[34][29] Texture: blackSquare.bmp	Moveable?: *false
BLOCK[34][30] Texture: blackSquare.bmp	Moveable?: *false
BLOCK[34][31] Texture: whiteSquare.bmp	Moveable?:  true
BLOCK[34][32] Texture: blackSquare.bmp	Moveable?: *false
BLOCK[34][33] Texture: blackSquare.bmp	Moveable?: *false
BLOCK[34][34] Texture: blackSquare.bmp	Moveable?: *false
BLOCK[34][35] Texture: blackSquare.bmp	Moveable?: *false
BLOCK[34][36] Texture: blackSquare.bmp	Moveable?: *false
BLOCK[34][37] Texture: blackSquare.bmp	Moveable?: *false
BLOCK[34][38] Texture: blackSquare.bmp	Moveable?: *false
BLOCK[34][39] Texture: blackSquare.bmp	Moveable?: *false
BLOCK[34][40] Texture: blackSquare.bmp	Moveable?: *false
BLOCK[34][41] Texture: blackSquare.bmp	Moveable?: *false
BLOCK[34][42] Texture: blackSquare.bmp	Moveable?: *false
BLOCK[34][43] Texture: blackSquare.bmp	Moveable?: *false
BLOCK[34][44] Texture: blackSquare.bmp	Moveable?: *false
BLOCK[34][45] Texture: blackSquare.bmp	Moveable?: *false
BLOCK[34][46] Texture: blackSquare.bmp	Moveable?: *false
BLOCK[34][47] Texture: whiteSquare.bmp	Moveable?:  true
BLOCK[34][48] Texture: blackSquare.bmp	Moveable?: *false
BLOCK[35][0] Texture: blackSquare.bmp	Moveable?: *false
BLOCK[35][1] Texture: whiteSquare.bmp	Moveable?:  true
BLOCK[35][2] Texture: blackSquare.bmp	Moveable?: *false
BLOCK[35][3] Texture: whiteSquare.bmp	Moveable?:  true
BLOCK[35][4] Texture: blackSquare.bmp	Moveable?: *false
BLOCK[35][5] Texture: whiteSquare.bmp	Moveable?:  true
BLOCK[35][6] Texture: blackSquare.bmp	Moveable?: *false
BLOCK[35][7] Texture: whiteSquare.bmp	Moveable?:  true
BLOCK[35][8] Texture: whiteSquare.bmp	Moveable?:  true
BLOCK[35][9] Texture: whiteSquare.bmp	Moveable?:  true
BLOCK[35][10] Texture: blackSquare.bmp	Moveable?: *false
BLOCK[35][11] Texture: whiteSquare.bmp	Moveable?:  true
BLOCK[35][12] Texture: whiteSquare.bmp	Moveable?:  true
BLOCK[35][13] Texture: whiteSquare.bmp	Moveable?:  true
BLOCK[35][14] Texture: blackSquare.bmp	Moveable?: *false
BLOCK[35][15] Texture: whiteSquare.bmp	Moveable?:  true
BLOCK[35][16] Texture: blackSquare.bmp	Moveable?: *false
BLOCK[35][17] Texture: whiteSquare.bmp	Moveable?:  true
BLOCK[35][18] Texture: blackSquare.bmp	Moveable?: *false
BLOCK[35][19] Texture: whiteSquare.bmp	Moveable?:  true
BLOCK[35][20] Texture: blackSquare.bmp	Moveable?: *false
BLOCK[35][21] Texture: whiteSquare.bmp	Moveable?:  true
BLOCK[35][22] Texture: whiteSquare.bmp	Moveable?:  true
BLOCK[35][23] Texture: whiteSquare.bmp	Moveable?:  true
BLOCK[35][24] Texture: blackSquare.bmp	Moveable?: *false
BLOCK[35][25] Texture: whiteSquare.bmp	Moveable?:  true
BLOCK[35][26] Texture: blackSquare.bmp	Moveable?: *false
BLOCK[35][27] Texture: whiteSquare.bmp	Moveable?:  true
BLOCK[35][28] Texture: whiteSquare.bmp	Moveable?:  true
BLOCK[35][29] Texture: whiteSquare.bmp	Moveable?:  true
BLOCK[35][30] Texture: whiteSquare.bmp	Moveable?:  true
BLOCK[35][31] Texture: whiteSquare.bmp	Moveable?:  true
BLOCK[35][32] Texture: blackSquare.bmp	Moveable?: *false
BLOCK[35][33] Texture: whiteSquare.bmp	Moveable?:  true
BLOCK[35][34] Texture: whiteSquare.bmp	Moveable?:  true
BLOCK[35][35] Texture: whiteSquare.bmp	Moveable?:  true
BLOCK[35][36] Texture: blackSquare.bmp	Moveable?: *false
BLOCK[35][37] Texture: whiteSquare.bmp	Moveable?:  true
BLOCK[35][38] Texture: whiteSquare.bmp	Moveable?:  true
BLOCK[35][39] Texture: whiteSquare.bmp	Moveable?:  true
BLOCK[35][40] Texture: whiteSquare.bmp	Moveable?:  true
BLOCK[35][41] Texture: whiteSquare.bmp	Moveable?:  true
BLOCK[35][42] Texture: blackSquare.bmp	Moveable?: *false
BLOCK[35][43] Texture: whiteSquare.bmp	Moveable?:  true
BLOCK[35][44] Texture: whiteSquare.bmp	Moveable?:  true
BLOCK[35][45] Texture: whiteSquare.bmp	Moveable?:  true
BLOCK[35][46] Texture: whiteSquare.bmp	Moveable?:  true
BLOCK[35][47] Texture: whiteSquare.bmp	Moveable?:  true
BLOCK[35][48] Texture: blackSquare.bmp	Moveable?: *false
BLOCK[36][0] Texture: blackSquare.bmp	Moveable?: *false
BLOCK[36][1] Texture: whiteSquare.bmp	Moveable?:  true
BLOCK[36][2] Texture: blackSquare.bmp	Moveable?: *false
BLOCK[36][3] Texture: whiteSquare.bmp	Moveable?:  true
BLOCK[36][4] Texture: blackSquare.bmp	Moveable?: *false
BLOCK[36][5] Texture: whiteSquare.bmp	Moveable?:  true
BLOCK[36][6] Texture: blackSquare.bmp	Moveable?: *false
BLOCK[36][7] Texture: blackSquare.bmp	Moveable?: *false
BLOCK[36][8] Texture: blackSquare.bmp	Moveable?: *false
BLOCK[36][9] Texture: whiteSquare.bmp	Moveable?:  true
BLOCK[36][10] Texture: blackSquare.bmp	Moveable?: *false
BLOCK[36][11] Texture: whiteSquare.bmp	Moveable?:  true
BLOCK[36][12] Texture: blackSquare.bmp	Moveable?: *false
BLOCK[36][13] Texture: whiteSquare.bmp	Moveable?:  true
BLOCK[36][14] Texture: blackSquare.bmp	Moveable?: *false
BLOCK[36][15] Texture: whiteSquare.bmp	Moveable?:  true
BLOCK[36][16] Texture: blackSquare.bmp	Moveable?: *false
BLOCK[36][17] Texture: blackSquare.bmp	Moveable?: *false
BLOCK[36][18] Texture: blackSquare.bmp	Moveable?: *false
BLOCK[36][19] Texture: whiteSquare.bmp	Moveable?:  true
BLOCK[36][20] Texture: blackSquare.bmp	Moveable?: *false
BLOCK[36][21] Texture: whiteSquare.bmp	Moveable?:  true
BLOCK[36][22] Texture: blackSquare.bmp	Moveable?: *false
BLOCK[36][23] Texture: whiteSquare.bmp	Moveable?:  true
BLOCK[36][24] Texture: blackSquare.bmp	Moveable?: *false
BLOCK[36][25] Texture: whiteSquare.bmp	Moveable?:  true
BLOCK[36][26] Texture: blackSquare.bmp	Moveable?: *false
BLOCK[36][27] Texture: blackSquare.bmp	Moveable?: *false
BLOCK[36][28] Texture: blackSquare.bmp	Moveable?: *false
BLOCK[36][29] Texture: blackSquare.bmp	Moveable?: *false
BLOCK[36][30] Texture: blackSquare.bmp	Moveable?: *false
BLOCK[36][31] Texture: blackSquare.bmp	Moveable?: *false
BLOCK[36][32] Texture: blackSquare.bmp	Moveable?: *false
BLOCK[36][33] Texture: whiteSquare.bmp	Moveable?:  true
BLOCK[36][34] Texture: blackSquare.bmp	Moveable?: *false
BLOCK[36][35] Texture: whiteSquare.bmp	Moveable?:  true
BLOCK[36][36] Texture: blackSquare.bmp	Moveable?: *false
BLOCK[36][37] Texture: whiteSquare.bmp	Moveable?:  true
BLOCK[36][38] Texture: blackSquare.bmp	Moveable?: *false
BLOCK[36][39] Texture: blackSquare.bmp	Moveable?: *false
BLOCK[36][40] Texture: blackSquare.bmp	Moveable?: *false
BLOCK[36][41] Texture: whiteSquare.bmp	Moveable?:  true
BLOCK[36][42] Texture: blackSquare.bmp	Moveable?: *false
BLOCK[36][43] Texture: whiteSquare.bmp	Moveable?:  true
BLOCK[36][44] Texture: blackSquare.bmp	Moveable?: *false
BLOCK[36][45] Texture: blackSquare.bmp	Moveable?: *false
BLOCK[36][46] Texture: blackSquare.bmp	Moveable?: *false
BLOCK[36][47] Texture: blackSquare.bmp	Moveable?: *false
BLOCK[36][48] Texture: blackSquare.bmp	Moveable?: *false
BLOCK[37][0] Texture: blackSquare.bmp	Moveable?: *false
BLOCK[37][1] Texture: whiteSquare.bmp	Moveable?:  true
BLOCK[37][2] Texture: blackSquare.bmp	Moveable?: *false
BLOCK[37][3] Texture: whiteSquare.bmp	Moveable?:  true
BLOCK[37][4] Texture: blackSquare.bmp	Moveable?: *false
BLOCK[37][5] Texture: whiteSquare.bmp	Moveable?:  true
BLOCK[37][6] Texture: whiteSquare.bmp	Moveable?:  true
BLOCK[37][7] Texture: whiteSquare.bmp	Moveable?:  true
BLOCK[37][8] Texture: blackSquare.bmp	Moveable?: *false
BLOCK[37][9] Texture: whiteSquare.bmp	Moveable?:  true
BLOCK[37][10] Texture: blackSquare.bmp	Moveable?: *false
BLOCK[37][11] Texture: whiteSquare.bmp	Moveable?:  true
BLOCK[37][12] Texture: blackSquare.bmp	Moveable?: *false
BLOCK[37][13] Texture: whiteSquare.bmp	Moveable?:  true
BLOCK[37][14] Texture: blackSquare.bmp	Moveable?: *false
BLOCK[37][15] Texture: whiteSquare.bmp	Moveable?:  true
BLOCK[37][16] Texture: whiteSquare.bmp	Moveable?:  true
BLOCK[37][17] Texture: whiteSquare.bmp	Moveable?:  true
BLOCK[37][18] Texture: blackSquare.bmp	Moveable?: *false
BLOCK[37][19] Texture: whiteSquare.bmp	Moveable?:  true
BLOCK[37][20] Texture: whiteSquare.bmp	Moveable?:  true
BLOCK[37][21] Texture: whiteSquare.bmp	Moveable?:  true
BLOCK[37][22] Texture: blackSquare.bmp	Moveable?: *false
BLOCK[37][23] Texture: whiteSquare.bmp	Moveable?:  true
BLOCK[37][24] Texture: blackSquare.bmp	Moveable?: *false
BLOCK[37][25] Texture: whiteSquare.bmp	Moveable?:  true
BLOCK[37][26] Texture: whiteSquare.bmp	Moveable?:  true
BLOCK[37][27] Texture: whiteSquare.bmp	Moveable?:  true
BLOCK[37][28] Texture: blackSquare.bmp	Moveable?: *false
BLOCK[37][29] Texture: whiteSquare.bmp	Moveable?:  true
BLOCK[37][30] Texture: whiteSquare.bmp	Moveable?:  true
BLOCK[37][31] Texture: whiteSquare.bmp	Moveable?:  true
BLOCK[37][32] Texture: whiteSquare.bmp	Moveable?:  true
BLOCK[37][33] Texture: whiteSquare.bmp	Moveable?:  true
BLOCK[37][34] Texture: blackSquare.bmp	Moveable?: *false
BLOCK[37][35] Texture: whiteSquare.bmp	Moveable?:  true
BLOCK[37][36] Texture: whiteSquare.bmp	Moveable?:  true
BLOCK[37][37] Texture: whiteSquare.bmp	Moveable?:  true
BLOCK[37][38] Texture: blackSquare.bmp	Moveable?: *false
BLOCK[37][39] Texture: whiteSquare.bmp	Moveable?:  true
BLOCK[37][40] Texture: whiteSquare.bmp	Moveable?:  true
BLOCK[37][41] Texture: whiteSquare.bmp	Moveable?:  true
BLOCK[37][42] Texture: blackSquare.bmp	Moveable?: *false
BLOCK[37][43] Texture: whiteSquare.bmp	Moveable?:  true
BLOCK[37][44] Texture: whiteSquare.bmp	Moveable?:  true
BLOCK[37][45] Texture: whiteSquare.bmp	Moveable?:  true
BLOCK[37][46] Texture: blackSquare.bmp	Moveable?: *false
BLOCK[37][47] Texture: whiteSquare.bmp	Moveable?:  true
BLOCK[37][48] Texture: blackSquare.bmp	Moveable?: *false
BLOCK[38][0] Texture: blackSquare.bmp	Moveable?: *false
BLOCK[38][1] Texture: blackSquare.bmp	Moveable?: *false
BLOCK[38][2] Texture: blackSquare.bmp	Moveable?: *false
BLOCK[38][3] Texture: whiteSquare.bmp	Moveable?:  true
BLOCK[38][4] Texture: blackSquare.bmp	Moveable?: *false
BLOCK[38][5] Texture: whiteSquare.bmp	Moveable?:  true
BLOCK[38][6] Texture: blackSquare.bmp	Moveable?: *false
BLOCK[38][7] Texture: whiteSquare.bmp	Moveable?:  true
BLOCK[38][8] Texture: blackSquare.bmp	Moveable?: *false
BLOCK[38][9] Texture: whiteSquare.bmp	Moveable?:  true
BLOCK[38][10] Texture: blackSquare.bmp	Moveable?: *false
BLOCK[38][11] Texture: whiteSquare.bmp	Moveable?:  true
BLOCK[38][12] Texture: blackSquare.bmp	Moveable?: *false
BLOCK[38][13] Texture: whiteSquare.bmp	Moveable?:  true
BLOCK[38][14] Texture: blackSquare.bmp	Moveable?: *false
BLOCK[38][15] Texture: blackSquare.bmp	Moveable?: *false
BLOCK[38][16] Texture: blackSquare.bmp	Moveable?: *false
BLOCK[38][17] Texture: whiteSquare.bmp	Moveable?:  true
BLOCK[38][18] Texture: blackSquare.bmp	Moveable?: *false
BLOCK[38][19] Texture: blackSquare.bmp	Moveable?: *false
BLOCK[38][20] Texture: blackSquare.bmp	Moveable?: *false
BLOCK[38][21] Texture: blackSquare.bmp	Moveable?: *false
BLOCK[38][22] Texture: blackSquare.bmp	Moveable?: *false
BLOCK[38][23] Texture: whiteSquare.bmp	Moveable?:  true
BLOCK[38][24] Texture: blackSquare.bmp	Moveable?: *false
BLOCK[38][25] Texture: whiteSquare.bmp	Moveable?:  true
BLOCK[38][26] Texture: blackSquare.bmp	Moveable?: *false
BLOCK[38][27] Texture: whiteSquare.bmp	Moveable?:  true
BLOCK[38][28] Texture: blackSquare.bmp	Moveable?: *false
BLOCK[38][29] Texture: whiteSquare.bmp	Moveable?:  true
BLOCK[38][30] Texture: blackSquare.bmp	Moveable?: *false
BLOCK[38][31] Texture: blackSquare.bmp	Moveable?: *false
BLOCK[38][32] Texture: blackSquare.bmp	Moveable?: *false
BLOCK[38][33] Texture: blackSquare.bmp	Moveable?: *false
BLOCK[38][34] Texture: blackSquare.bmp	Moveable?: *false
BLOCK[38][35] Texture: blackSquare.bmp	Moveable?: *false
BLOCK[38][36] Texture: blackSquare.bmp	Moveable?: *false
BLOCK[38][37] Texture: blackSquare.bmp	Moveable?: *false
BLOCK[38][38] Texture: blackSquare.bmp	Moveable?: *false
BLOCK[38][39] Texture: whiteSquare.bmp	Moveable?:  true
BLOCK[38][40] Texture: blackSquare.bmp	Moveable?: *false
BLOCK[38][41] Texture: blackSquare.bmp	Moveable?: *false
BLOCK[38][42] Texture: blackSquare.bmp	Moveable?: *false
BLOCK[38][43] Texture: blackSquare.bmp	Moveable?: *false
BLOCK[38][44] Texture: blackSquare.bmp	Moveable?: *false
BLOCK[38][45] Texture: whiteSquare.bmp	Moveable?:  true
BLOCK[38][46] Texture: blackSquare.bmp	Moveable?: *false
BLOCK[38][47] Texture: whiteSquare.bmp	Moveable?:  true
BLOCK[38][48] Texture: blackSquare.bmp	Moveable?: *false
BLOCK[39][0] Texture: blackSquare.bmp	Moveable?: *false
BLOCK[39][1] Texture: whiteSquare.bmp	Moveable?:  true
BLOCK[39][2] Texture: whiteSquare.bmp	Moveable?:  true
BLOCK[39][3] Texture: whiteSquare.bmp	Moveable?:  true
BLOCK[39][4] Texture: blackSquare.bmp	Moveable?: *false
BLOCK[39][5] Texture: whiteSquare.bmp	Moveable?:  true
BLOCK[39][6] Texture: blackSquare.bmp	Moveable?: *false
BLOCK[39][7] Texture: whiteSquare.bmp	Moveable?:  true
BLOCK[39][8] Texture: whiteSquare.bmp	Moveable?:  true
BLOCK[39][9] Texture: whiteSquare.bmp	Moveable?:  true
BLOCK[39][10] Texture: whiteSquare.bmp	Moveable?:  true
BLOCK[39][11] Texture: whiteSquare.bmp	Moveable?:  true
BLOCK[39][12] Texture: blackSquare.bmp	Moveable?: *false
BLOCK[39][13] Texture: whiteSquare.bmp	Moveable?:  true
BLOCK[39][14] Texture: whiteSquare.bmp	Moveable?:  true
BLOCK[39][15] Texture: whiteSquare.bmp	Moveable?:  true
BLOCK[39][16] Texture: blackSquare.bmp	Moveable?: *false
BLOCK[39][17] Texture: whiteSquare.bmp	Moveable?:  true
BLOCK[39][18] Texture: blackSquare.bmp	Moveable?: *false
BLOCK[39][19] Texture: whiteSquare.bmp	Moveable?:  true
BLOCK[39][20] Texture: whiteSquare.bmp	Moveable?:  true
BLOCK[39][21] Texture: whiteSquare.bmp	Moveable?:  true
BLOCK[39][22] Texture: whiteSquare.bmp	Moveable?:  true
BLOCK[39][23] Texture: whiteSquare.bmp	Moveable?:  true
BLOCK[39][24] Texture: blackSquare.bmp	Moveable?: *false
BLOCK[39][25] Texture: whiteSquare.bmp	Moveable?:  true
BLOCK[39][26] Texture: blackSquare.bmp	Moveable?: *false
BLOCK[39][27] Texture: whiteSquare.bmp	Moveable?:  true
BLOCK[39][28] Texture: blackSquare.bmp	Moveable?: *false
BLOCK[39][29] Texture: whiteSquare.bmp	Moveable?:  true
BLOCK[39][30] Texture: whiteSquare.bmp	Moveable?:  true
BLOCK[39][31] Texture: whiteSquare.bmp	Moveable?:  true
BLOCK[39][32] Texture: blackSquare.bmp	Moveable?: *false
BLOCK[39][33] Texture: whiteSquare.bmp	Moveable?:  true
BLOCK[39][34] Texture: whiteSquare.bmp	Moveable?:  true
BLOCK[39][35] Texture: whiteSquare.bmp	Moveable?:  true
BLOCK[39][36] Texture: whiteSquare.bmp	Moveable?:  true
BLOCK[39][37] Texture: whiteSquare.bmp	Moveable?:  true
BLOCK[39][38] Texture: blackSquare.bmp	Moveable?: *false
BLOCK[39][39] Texture: whiteSquare.bmp	Moveable?:  true
BLOCK[39][40] Texture: blackSquare.bmp	Moveable?: *false
BLOCK[39][41] Texture: whiteSquare.bmp	Moveable?:  true
BLOCK[39][42] Texture: blackSquare.bmp	Moveable?: *false
BLOCK[39][43] Texture: whiteSquare.bmp	Moveable?:  true
BLOCK[39][44] Texture: whiteSquare.bmp	Moveable?:  true
BLOCK[39][45] Texture: whiteSquare.bmp	Moveable?:  true
BLOCK[39][46] Texture: blackSquare.bmp	Moveable?: *false
BLOCK[39][47] Texture: whiteSquare.bmp	Moveable?:  true
BLOCK[39][48] Texture: blackSquare.bmp	Moveable?: *false
BLOCK[40][0] Texture: blackSquare.bmp	Moveable?: *false
BLOCK[40][1] Texture: whiteSquare.bmp	Moveable?:  true
BLOCK[40][2] Texture: blackSquare.bmp	Moveable?: *false
BLOCK[40][3] Texture: blackSquare.bmp	Moveable?: *false
BLOCK[40][4] Texture: blackSquare.bmp	Moveable?: *false
BLOCK[40][5] Texture: blackSquare.bmp	Moveable?: *false
BLOCK[40][6] Texture: blackSquare.bmp	Moveable?: *false
BLOCK[40][7] Texture: blackSquare.bmp	Moveable?: *false
BLOCK[40][8] Texture: blackSquare.bmp	Moveable?: *false
BLOCK[40][9] Texture: blackSquare.bmp	Moveable?: *false
BLOCK[40][10] Texture: blackSquare.bmp	Moveable?: *false
BLOCK[40][11] Texture: blackSquare.bmp	Moveable?: *false
BLOCK[40][12] Texture: blackSquare.bmp	Moveable?: *false
BLOCK[40][13] Texture: whiteSquare.bmp	Moveable?:  true
BLOCK[40][14] Texture: blackSquare.bmp	Moveable?: *false
BLOCK[40][15] Texture: blackSquare.bmp	Moveable?: *false
BLOCK[40][16] Texture: blackSquare.bmp	Moveable?: *false
BLOCK[40][17] Texture: whiteSquare.bmp	Moveable?:  true
BLOCK[40][18] Texture: blackSquare.bmp	Moveable?: *false
BLOCK[40][19] Texture: whiteSquare.bmp	Moveable?:  true
BLOCK[40][20] Texture: blackSquare.bmp	Moveable?: *false
BLOCK[40][21] Texture: blackSquare.bmp	Moveable?: *false
BLOCK[40][22] Texture: blackSquare.bmp	Moveable?: *false
BLOCK[40][23] Texture: blackSquare.bmp	Moveable?: *false
BLOCK[40][24] Texture: blackSquare.bmp	Moveable?: *false
BLOCK[40][25] Texture: whiteSquare.bmp	Moveable?:  true
BLOCK[40][26] Texture: blackSquare.bmp	Moveable?: *false
BLOCK[40][27] Texture: whiteSquare.bmp	Moveable?:  true
BLOCK[40][28] Texture: blackSquare.bmp	Moveable?: *false
BLOCK[40][29] Texture: blackSquare.bmp	Moveable?: *false
BLOCK[40][30] Texture: blackSquare.bmp	Moveable?: *false
BLOCK[40][31] Texture: whiteSquare.bmp	Moveable?:  true
BLOCK[40][32] Texture: blackSquare.bmp	Moveable?: *false
BLOCK[40][33] Texture: whiteSquare.bmp	Moveable?:  true
BLOCK[40][34] Texture: blackSquare.bmp	Moveable?: *false
BLOCK[40][35] Texture: blackSquare.bmp	Moveable?: *false
BLOCK[40][36] Texture: blackSquare.bmp	Moveable?: *false
BLOCK[40][37] Texture: blackSquare.bmp	Moveable?: *false
BLOCK[40][38] Texture: blackSquare.bmp	Moveable?: *false
BLOCK[40][39] Texture: whiteSquare.bmp	Moveable?:  true
BLOCK[40][40] Texture: blackSquare.bmp	Moveable?: *false
BLOCK[40][41] Texture: whiteSquare.bmp	Moveable?:  true
BLOCK[40][42] Texture: blackSquare.bmp	Moveable?: *false
BLOCK[40][43] Texture: whiteSquare.bmp	Moveable?:  true
BLOCK[40][44] Texture: blackSquare.bmp	Moveable?: *false
BLOCK[40][45] Texture: blackSquare.bmp	Moveable?: *false
BLOCK[40][46] Texture: blackSquare.bmp	Moveable?: *false
BLOCK[40][47] Texture: whiteSquare.bmp	Moveable?:  true
BLOCK[40][48] Texture: blackSquare.bmp	Moveable?: *false
BLOCK[41][0] Texture: blackSquare.bmp	Moveable?: *false
BLOCK[41][1] Texture: whiteSquare.bmp	Moveable?:  true
BLOCK[41][2] Texture: whiteSquare.bmp	Moveable?:  true
BLOCK[41][3] Texture: whiteSquare.bmp	Moveable?:  true
BLOCK[41][4] Texture: whiteSquare.bmp	Moveable?:  true
BLOCK[41][5] Texture: whiteSquare.bmp	Moveable?:  true
BLOCK[41][6] Texture: whiteSquare.bmp	Moveable?:  true
BLOCK[41][7] Texture: whiteSquare.bmp	Moveable?:  true
BLOCK[41][8] Texture: whiteSquare.bmp	Moveable?:  true
BLOCK[41][9] Texture: whiteSquare.bmp	Moveable?:  true
BLOCK[41][10] Texture: whiteSquare.bmp	Moveable?:  true
BLOCK[41][11] Texture: whiteSquare.bmp	Moveable?:  true
BLOCK[41][12] Texture: blackSquare.bmp	Moveable?: *false
BLOCK[41][13] Texture: whiteSquare.bmp	Moveable?:  true
BLOCK[41][14] Texture: blackSquare.bmp	Moveable?: *false
BLOCK[41][15] Texture: whiteSquare.bmp	Moveable?:  true
BLOCK[41][16] Texture: whiteSquare.bmp	Moveable?:  true
BLOCK[41][17] Texture: whiteSquare.bmp	Moveable?:  true
BLOCK[41][18] Texture: blackSquare.bmp	Moveable?: *false
BLOCK[41][19] Texture: whiteSquare.bmp	Moveable?:  true
BLOCK[41][20] Texture: whiteSquare.bmp	Moveable?:  true
BLOCK[41][21] Texture: whiteSquare.bmp	Moveable?:  true
BLOCK[41][22] Texture: blackSquare.bmp	Moveable?: *false
BLOCK[41][23] Texture: whiteSquare.bmp	Moveable?:  true
BLOCK[41][24] Texture: whiteSquare.bmp	Moveable?:  true
BLOCK[41][25] Texture: whiteSquare.bmp	Moveable?:  true
BLOCK[41][26] Texture: blackSquare.bmp	Moveable?: *false
BLOCK[41][27] Texture: whiteSquare.bmp	Moveable?:  true
BLOCK[41][28] Texture: whiteSquare.bmp	Moveable?:  true
BLOCK[41][29] Texture: whiteSquare.bmp	Moveable?:  true
BLOCK[41][30] Texture: whiteSquare.bmp	Moveable?:  true
BLOCK[41][31] Texture: whiteSquare.bmp	Moveable?:  true
BLOCK[41][32] Texture: blackSquare.bmp	Moveable?: *false
BLOCK[41][33] Texture: whiteSquare.bmp	Moveable?:  true
BLOCK[41][34] Texture: whiteSquare.bmp	Moveable?:  true
BLOCK[41][35] Texture: whiteSquare.bmp	Moveable?:  true
BLOCK[41][36] Texture: blackSquare.bmp	Moveable?: *false
BLOCK[41][37] Texture: whiteSquare.bmp	Moveable?:  true
BLOCK[41][38] Texture: whiteSquare.bmp	Moveable?:  true
BLOCK[41][39] Texture: whiteSquare.bmp	Moveable?:  true
BLOCK[41][40] Texture: whiteSquare.bmp	Moveable?:  true
BLOCK[41][41] Texture: whiteSquare.bmp	Moveable?:  true
BLOCK[41][42] Texture: blackSquare.bmp	Moveable?: *false
BLOCK[41][43] Texture: whiteSquare.bmp	Moveable?:  true
BLOCK[41][44] Texture: blackSquare.bmp	Moveable?: *false
BLOCK[41][45] Texture: whiteSquare.bmp	Moveable?:  true
BLOCK[41][46] Texture: whiteSquare.bmp	Moveable?:  true
BLOCK[41][47] Texture: whiteSquare.bmp	Moveable?:  true
BLOCK[41][48] Texture: blackSquare.bmp	Moveable?: *false
BLOCK[42][0] Texture: blackSquare.bmp	Moveable?: *false
BLOCK[42][1] Texture: whiteSquare.bmp	Moveable?:  true
BLOCK[42][2] Texture: blackSquare.bmp	Moveable?: *false
BLOCK[42][3] Texture: blackSquare.bmp	Moveable?: *false
BLOCK[42][4] Texture: blackSquare.bmp	Moveable?: *false
BLOCK[42][5] Texture: blackSquare.bmp	Moveable?: *false
BLOCK[42][6] Texture: blackSquare.bmp	Moveable?: *false
BLOCK[42][7] Texture: blackSquare.bmp	Moveable?: *false
BLOCK[42][8] Texture: blackSquare.bmp	Moveable?: *false
BLOCK[42][9] Texture: blackSquare.bmp	Moveable?: *false
BLOCK[42][10] Texture: blackSquare.bmp	Moveable?: *false
BLOCK[42][11] Texture: whiteSquare.bmp	Moveable?:  true
BLOCK[42][12] Texture: blackSquare.bmp	Moveable?: *false
BLOCK[42][13] Texture: whiteSquare.bmp	Moveable?:  true
BLOCK[42][14] Texture: blackSquare.bmp	Moveable?: *false
BLOCK[42][15] Texture: whiteSquare.bmp	Moveable?:  true
BLOCK[42][16] Texture: blackSquare.bmp	Moveable?: *false
BLOCK[42][17] Texture: blackSquare.bmp	Moveable?: *false
BLOCK[42][18] Texture: blackSquare.bmp	Moveable?: *false
BLOCK[42][19] Texture: blackSquare.bmp	Moveable?: *false
BLOCK[42][20] Texture: blackSquare.bmp	Moveable?: *false
BLOCK[42][21] Texture: whiteSquare.bmp	Moveable?:  true
BLOCK[42][22] Texture: blackSquare.bmp	Moveable?: *false
BLOCK[42][23] Texture: whiteSquare.bmp	Moveable?:  true
BLOCK[42][24] Texture: blackSquare.bmp	Moveable?: *false
BLOCK[42][25] Texture: blackSquare.bmp	Moveable?: *false
BLOCK[42][26] Texture: blackSquare.bmp	Moveable?: *false
BLOCK[42][27] Texture: blackSquare.bmp	Moveable?: *false
BLOCK[42][28] Texture: blackSquare.bmp	Moveable?: *false
BLOCK[42][29] Texture: blackSquare.bmp	Moveable?: *false
BLOCK[42][30] Texture: blackSquare.bmp	Moveable?: *false
BLOCK[42][31] Texture: blackSquare.bmp	Moveable?: *false
BLOCK[42][32] Texture: blackSquare.bmp	Moveable?: *false
BLOCK[42][33] Texture: whiteSquare.bmp	Moveable?:  true
BLOCK[42][34] Texture: blackSquare.bmp	Moveable?: *false
BLOCK[42][35] Texture: whiteSquare.bmp	Moveable?:  true
BLOCK[42][36] Texture: blackSquare.bmp	Moveable?: *false
BLOCK[42][37] Texture: whiteSquare.bmp	Moveable?:  true
BLOCK[42][38] Texture: blackSquare.bmp	Moveable?: *false
BLOCK[42][39] Texture: blackSquare.bmp	Moveable?: *false
BLOCK[42][40] Texture: blackSquare.bmp	Moveable?: *false
BLOCK[42][41] Texture: blackSquare.bmp	Moveable?: *false
BLOCK[42][42] Texture: blackSquare.bmp	Moveable?: *false
BLOCK[42][43] Texture: whiteSquare.bmp	Moveable?:  true
BLOCK[42][44] Texture: blackSquare.bmp	Moveable?: *false
BLOCK[42][45] Texture: whiteSquare.bmp	Moveable?:  true
BLOCK[42][46] Texture: blackSquare.bmp	Moveable?: *false
BLOCK[42][47] Texture: whiteSquare.bmp	Moveable?:  true
BLOCK[42][48] Texture: blackSquare.bmp	Moveable?: *false
BLOCK[43][0] Texture: blackSquare.bmp	Moveable?: *false
BLOCK[43][1] Texture: whiteSquare.bmp	Moveable?:  true
BLOCK[43][2] Texture: blackSquare.bmp	Moveable?: *false
BLOCK[43][3] Texture: whiteSquare.bmp	Moveable?:  true
BLOCK[43][4] Texture: whiteSquare.bmp	Moveable?:  true
BLOCK[43][5] Texture: whiteSquare.bmp	Moveable?:  true
BLOCK[43][6] Texture: whiteSquare.bmp	Moveable?:  true
BLOCK[43][7] Texture: whiteSquare.bmp	Moveable?:  true
BLOCK[43][8] Texture: whiteSquare.bmp	Moveable?:  true
BLOCK[43][9] Texture: whiteSquare.bmp	Moveable?:  true
BLOCK[43][10] Texture: blackSquare.bmp	Moveable?: *false
BLOCK[43][11] Texture: whiteSquare.bmp	Moveable?:  true
BLOCK[43][12] Texture: blackSquare.bmp	Moveable?: *false
BLOCK[43][13] Texture: whiteSquare.bmp	Moveable?:  true
BLOCK[43][14] Texture: blackSquare.bmp	Moveable?: *false
BLOCK[43][15] Texture: whiteSquare.bmp	Moveable?:  true
BLOCK[43][16] Texture: whiteSquare.bmp	Moveable?:  true
BLOCK[43][17] Texture: whiteSquare.bmp	Moveable?:  true
BLOCK[43][18] Texture: whiteSquare.bmp	Moveable?:  true
BLOCK[43][19] Texture: whiteSquare.bmp	Moveable?:  true
BLOCK[43][20] Texture: blackSquare.bmp	Moveable?: *false
BLOCK[43][21] Texture: whiteSquare.bmp	Moveable?:  true
BLOCK[43][22] Texture: blackSquare.bmp	Moveable?: *false
BLOCK[43][23] Texture: whiteSquare.bmp	Moveable?:  true
BLOCK[43][24] Texture: blackSquare.bmp	Moveable?: *false
BLOCK[43][25] Texture: whiteSquare.bmp	Moveable?:  true
BLOCK[43][26] Texture: whiteSquare.bmp	Moveable?:  true
BLOCK[43][27] Texture: whiteSquare.bmp	Moveable?:  true
BLOCK[43][28] Texture: whiteSquare.bmp	Moveable?:  true
BLOCK[43][29] Texture: whiteSquare.bmp	Moveable?:  true
BLOCK[43][30] Texture: whiteSquare.bmp	Moveable?:  true
BLOCK[43][31] Texture: whiteSquare.bmp	Moveable?:  true
BLOCK[43][32] Texture: whiteSquare.bmp	Moveable?:  true
BLOCK[43][33] Texture: whiteSquare.bmp	Moveable?:  true
BLOCK[43][34] Texture: blackSquare.bmp	Moveable?: *false
BLOCK[43][35] Texture: whiteSquare.bmp	Moveable?:  true
BLOCK[43][36] Texture: whiteSquare.bmp	Moveable?:  true
BLOCK[43][37] Texture: whiteSquare.bmp	Moveable?:  true
BLOCK[43][38] Texture: whiteSquare.bmp	Moveable?:  true
BLOCK[43][39] Texture: whiteSquare.bmp	Moveable?:  true
BLOCK[43][40] Texture: blackSquare.bmp	Moveable?: *false
BLOCK[43][41] Texture: whiteSquare.bmp	Moveable?:  true
BLOCK[43][42] Texture: whiteSquare.bmp	Moveable?:  true
BLOCK[43][43] Texture: whiteSquare.bmp	Moveable?:  true
BLOCK[43][44] Texture: blackSquare.bmp	Moveable?: *false
BLOCK[43][45] Texture: whiteSquare.bmp	Moveable?:  true
BLOCK[43][46] Texture: blackSquare.bmp	Moveable?: *false
BLOCK[43][47] Texture: whiteSquare.bmp	Moveable?:  true
BLOCK[43][48] Texture: blackSquare.bmp	Moveable?: *false
BLOCK[44][0] Texture: blackSquare.bmp	Moveable?: *false
BLOCK[44][1] Texture: whiteSquare.bmp	Moveable?:  true
BLOCK[44][2] Texture: blackSquare.bmp	Moveable?: *false
BLOCK[44][3] Texture: blackSquare.bmp	Moveable?: *false
BLOCK[44][4] Texture: blackSquare.bmp	Moveable?: *false
BLOCK[44][5] Texture: whiteSquare.bmp	Moveable?:  true
BLOCK[44][6] Texture: blackSquare.bmp	Moveable?: *false
BLOCK[44][7] Texture: whiteSquare.bmp	Moveable?:  true
BLOCK[44][8] Texture: blackSquare.bmp	Moveable?: *false
BLOCK[44][9] Texture: blackSquare.bmp	Moveable?: *false
BLOCK[44][10] Texture: blackSquare.bmp	Moveable?: *false
BLOCK[44][11] Texture: whiteSquare.bmp	Moveable?:  true
BLOCK[44][12] Texture: blackSquare.bmp	Moveable?: *false
BLOCK[44][13] Texture: whiteSquare.bmp	Moveable?:  true
BLOCK[44][14] Texture: blackSquare.bmp	Moveable?: *false
BLOCK[44][15] Texture: blackSquare.bmp	Moveable?: *false
BLOCK[44][16] Texture: blackSquare.bmp	Moveable?: *false
BLOCK[44][17] Texture: blackSquare.bmp	Moveable?: *false
BLOCK[44][18] Texture: blackSquare.bmp	Moveable?: *false
BLOCK[44][19] Texture: whiteSquare.bmp	Moveable?:  true
BLOCK[44][20] Texture: blackSquare.bmp	Moveable?: *false
BLOCK[44][21] Texture: whiteSquare.bmp	Moveable?:  true
BLOCK[44][22] Texture: blackSquare.bmp	Moveable?: *false
BLOCK[44][23] Texture: whiteSquare.bmp	Moveable?:  true
BLOCK[44][24] Texture: blackSquare.bmp	Moveable?: *false
BLOCK[44][25] Texture: blackSquare.bmp	Moveable?: *false
BLOCK[44][26] Texture: blackSquare.bmp	Moveable?: *false
BLOCK[44][27] Texture: blackSquare.bmp	Moveable?: *false
BLOCK[44][28] Texture: blackSquare.bmp	Moveable?: *false
BLOCK[44][29] Texture: blackSquare.bmp	Moveable?: *false
BLOCK[44][30] Texture: blackSquare.bmp	Moveable?: *false
BLOCK[44][31] Texture: whiteSquare.bmp	Moveable?:  true
BLOCK[44][32] Texture: blackSquare.bmp	Moveable?: *false
BLOCK[44][33] Texture: blackSquare.bmp	Moveable?: *false
BLOCK[44][34] Texture: blackSquare.bmp	Moveable?: *false
BLOCK[44][35] Texture: blackSquare.bmp	Moveable?: *false
BLOCK[44][36] Texture: blackSquare.bmp	Moveable?: *false
BLOCK[44][37] Texture: blackSquare.bmp	Moveable?: *false
BLOCK[44][38] Texture: blackSquare.bmp	Moveable?: *false
BLOCK[44][39] Texture: blackSquare.bmp	Moveable?: *false
BLOCK[44][40] Texture: blackSquare.bmp	Moveable?: *false
BLOCK[44][41] Texture: whiteSquare.bmp	Moveable?:  true
BLOCK[44][42] Texture: blackSquare.bmp	Moveable?: *false
BLOCK[44][43] Texture: blackSquare.bmp	Moveable?: *false
BLOCK[44][44] Texture: blackSquare.bmp	Moveable?: *false
BLOCK[44][45] Texture: whiteSquare.bmp	Moveable?:  true
BLOCK[44][46] Texture: blackSquare.bmp	Moveable?: *false
BLOCK[44][47] Texture: whiteSquare.bmp	Moveable?:  true
BLOCK[44][48] Texture: blackSquare.bmp	Moveable?: *false
BLOCK[45][0] Texture: blackSquare.bmp	Moveable?: *false
BLOCK[45][1] Texture: whiteSquare.bmp	Moveable?:  true
BLOCK[45][2] Texture: whiteSquare.bmp	Moveable?:  true
BLOCK[45][3] Texture: whiteSquare.bmp	Moveable?:  true
BLOCK[45][4] Texture: blackSquare.bmp	Moveable?: *false
BLOCK[45][5] Texture: whiteSquare.bmp	Moveable?:  true
BLOCK[45][6] Texture: blackSquare.bmp	Moveable?: *false
BLOCK[45][7] Texture: whiteSquare.bmp	Moveable?:  true
BLOCK[45][8] Texture: whiteSquare.bmp	Moveable?:  true
BLOCK[45][9] Texture: whiteSquare.bmp	Moveable?:  true
BLOCK[45][10] Texture: blackSquare.bmp	Moveable?: *false
BLOCK[45][11] Texture: whiteSquare.bmp	Moveable?:  true
BLOCK[45][12] Texture: blackSquare.bmp	Moveable?: *false
BLOCK[45][13] Texture: whiteSquare.bmp	Moveable?:  true
BLOCK[45][14] Texture: blackSquare.bmp	Moveable?: *false
BLOCK[45][15] Texture: whiteSquare.bmp	Moveable?:  true
BLOCK[45][16] Texture: whiteSquare.bmp	Moveable?:  true
BLOCK[45][17] Texture: whiteSquare.bmp	Moveable?:  true
BLOCK[45][18] Texture: blackSquare.bmp	Moveable?: *false
BLOCK[45][19] Texture: whiteSquare.bmp	Moveable?:  true
BLOCK[45][20] Texture: whiteSquare.bmp	Moveable?:  true
BLOCK[45][21] Texture: whiteSquare.bmp	Moveable?:  true
BLOCK[45][22] Texture: whiteSquare.bmp	Moveable?:  true
BLOCK[45][23] Texture: whiteSquare.bmp	Moveable?:  true
BLOCK[45][24] Texture: blackSquare.bmp	Moveable?: *false
BLOCK[45][25] Texture: whiteSquare.bmp	Moveable?:  true
BLOCK[45][26] Texture: whiteSquare.bmp	Moveable?:  true
BLOCK[45][27] Texture: whiteSquare.bmp	Moveable?:  true
BLOCK[45][28] Texture: whiteSquare.bmp	Moveable?:  true
BLOCK[45][29] Texture: whiteSquare.bmp	Moveable?:  true
BLOCK[45][30] Texture: blackSquare.bmp	Moveable?: *false
BLOCK[45][31] Texture: whiteSquare.bmp	Moveable?:  true
BLOCK[45][32] Texture: blackSquare.bmp	Moveable?: *false
BLOCK[45][33] Texture: whiteSquare.bmp	Moveable?:  true
BLOCK[45][34] Texture: whiteSquare.bmp	Moveable?:  true
BLOCK[45][35] Texture: whiteSquare.bmp	Moveable?:  true
BLOCK[45][36] Texture: blackSquare.bmp	Moveable?: *false
BLOCK[45][37] Texture: whiteSquare.bmp	Moveable?:  true
BLOCK[45][38] Texture: whiteSquare.bmp	Moveable?:  true
BLOCK[45][39] Texture: whiteSquare.bmp	Moveable?:  true
BLOCK[45][40] Texture: blackSquare.bmp	Moveable?: *false
BLOCK[45][41] Texture: whiteSquare.bmp	Moveable?:  true
BLOCK[45][42] Texture: blackSquare.bmp	Moveable?: *false
BLOCK[45][43] Texture: whiteSquare.bmp	Moveable?:  true
BLOCK[45][44] Texture: whiteSquare.bmp	Moveable?:  true
BLOCK[45][45] Texture: whiteSquare.bmp	Moveable?:  true
BLOCK[45][46] Texture: blackSquare.bmp	Moveable?: *false
BLOCK[45][47] Texture: whiteSquare.bmp	Moveable?:  true
BLOCK[45][48] Texture: blackSquare.bmp	Moveable?: *false
BLOCK[46][0] Texture: blackSquare.bmp	Moveable?: *false
BLOCK[46][1] Texture: blackSquare.bmp	Moveable?: *false
BLOCK[46][2] Texture: blackSquare.bmp	Moveable?: *false
BLOCK[46][3] Texture: whiteSquare.bmp	Moveable?:  true
BLOCK[46][4] Texture: blackSquare.bmp	Moveable?: *false
BLOCK[46][5] Texture: blackSquare.bmp	Moveable?: *false
BLOCK[46][6] Texture: blackSquare.bmp	Moveable?: *false
BLOCK[46][7] Texture: blackSquare.bmp	Moveable?: *false
BLOCK[46][8] Texture: blackSquare.bmp	Moveable?: *false
BLOCK[46][9] Texture: whiteSquare.bmp	Moveable?:  true
BLOCK[46][10] Texture: blackSquare.bmp	Moveable?: *false
BLOCK[46][11] Texture: whiteSquare.bmp	Moveable?:  true
BLOCK[46][12] Texture: blackSquare.bmp	Moveable?: *false
BLOCK[46][13] Texture: blackSquare.bmp	Moveable?: *false
BLOCK[46][14] Texture: blackSquare.bmp	Moveable?: *false
BLOCK[46][15] Texture: whiteSquare.bmp	Moveable?:  true
BLOCK[46][16] Texture: blackSquare.bmp	Moveable?: *false
BLOCK[46][17] Texture: whiteSquare.bmp	Moveable?:  true
BLOCK[46][18] Texture: blackSquare.bmp	Moveable?: *false
BLOCK[46][19] Texture: blackSquare.bmp	Moveable?: *false
BLOCK[46][20] Texture: blackSquare.bmp	Moveable?: *false
BLOCK[46][21] Texture: blackSquare.bmp	Moveable?: *false
BLOCK[46][22] Texture: blackSquare.bmp	Moveable?: *false
BLOCK[46][23] Texture: blackSquare.bmp	Moveable?: *false
BLOCK[46][24] Texture: blackSquare.bmp	Moveable?: *false
BLOCK[46][25] Texture: whiteSquare.bmp	Moveable?:  true
BLOCK[46][26] Texture: blackSquare.bmp	Moveable?: *false
BLOCK[46][27] Texture: blackSquare.bmp	Moveable?: *false
BLOCK[46][28] Texture: blackSquare.bmp	Moveable?: *false
BLOCK[46][29] Texture: whiteSquare.bmp	Moveable?:  true
BLOCK[46][30] Texture: blackSquare.bmp	Moveable?: *false
BLOCK[46][31] Texture: blackSquare.bmp	Moveable?: *false
BLOCK[46][32] Texture: blackSquare.bmp	Moveable?: *false
BLOCK[46][33] Texture: whiteSquare.bmp	Moveable?:  true
BLOCK[46][34] Texture: blackSquare.bmp	Moveable?: *false
BLOCK[46][35] Texture: whiteSquare.bmp	Moveable?:  true
BLOCK[46][36] Texture: blackSquare.bmp	Moveable?: *false
BLOCK[46][37] Texture: whiteSquare.bmp	Moveable?:  true
BLOCK[46][38] Texture: blackSquare.bmp	Moveable?: *false
BLOCK[46][39] Texture: whiteSquare.bmp	Moveable?:  true
BLOCK[46][40] Texture: blackSquare.bmp	Moveable?: *false
BLOCK[46][41] Texture: whiteSquare.bmp	Moveable?:  true
BLOCK[46][42] Texture: blackSquare.bmp	Moveable?: *false
BLOCK[46][43] Texture: blackSquare.bmp	Moveable?: *false
BLOCK[46][44] Texture: blackSquare.bmp	Moveable?: *false
BLOCK[46][45] Texture: whiteSquare.bmp	Moveable?:  true
BLOCK[46][46] Texture: blackSquare.bmp	Moveable?: *false
BLOCK[46][47] Texture: whiteSquare.bmp	Moveable?:  true
BLOCK[46][48] Texture: blackSquare.bmp	Moveable?: *false
BLOCK[47][0] Texture: blackSquare.bmp	Moveable?: *false
BLOCK[47][1] Texture: whiteSquare.bmp	Moveable?:  true
BLOCK[47][2] Texture: whiteSquare.bmp	Moveable?:  true
BLOCK[47][3] Texture: whiteSquare.bmp	Moveable?:  true
BLOCK[47][4] Texture: whiteSquare.bmp	Moveable?:  true
BLOCK[47][5] Texture: whiteSquare.bmp	Moveable?:  true
BLOCK[47][6] Texture: whiteSquare.bmp	Moveable?:  true
BLOCK[47][7] Texture: whiteSquare.bmp	Moveable?:  true
BLOCK[47][8] Texture: whiteSquare.bmp	Moveable?:  true
BLOCK[47][9] Texture: whiteSquare.bmp	Moveable?:  true
BLOCK[47][10] Texture: blackSquare.bmp	Moveable?: *false
BLOCK[47][11] Texture: whiteSquare.bmp	Moveable?:  true
BLOCK[47][12] Texture: whiteSquare.bmp	Moveable?:  true
BLOCK[47][13] Texture: whiteSquare.bmp	Moveable?:  true
BLOCK[47][14] Texture: whiteSquare.bmp	Moveable?:  true
BLOCK[47][15] Texture: whiteSquare.bmp	Moveable?:  true
BLOCK[47][16] Texture: blackSquare.bmp	Moveable?: *false
BLOCK[47][17] Texture: whiteSquare.bmp	Moveable?:  true
BLOCK[47][18] Texture: whiteSquare.bmp	Moveable?:  true
BLOCK[47][19] Texture: whiteSquare.bmp	Moveable?:  true
BLOCK[47][20] Texture: whiteSquare.bmp	Moveable?:  true
BLOCK[47][21] Texture: whiteSquare.bmp	Moveable?:  true
BLOCK[47][22] Texture: whiteSquare.bmp	Moveable?:  true
BLOCK[47][23] Texture: whiteSquare.bmp	Moveable?:  true
BLOCK[47][24] Texture: whiteSquare.bmp	Moveable?:  true
BLOCK[47][25] Texture: whiteSquare.bmp	Moveable?:  true
BLOCK[47][26] Texture: whiteSquare.bmp	Moveable?:  true
BLOCK[47][27] Texture: whiteSquare.bmp	Moveable?:  true
BLOCK[47][28] Texture: blackSquare.bmp	Moveable?: *false
BLOCK[47][29] Texture: whiteSquare.bmp	Moveable?:  true
BLOCK[47][30] Texture: whiteSquare.bmp	Moveable?:  true
BLOCK[47][31] Texture: whiteSquare.bmp	Moveable?:  true
BLOCK[47][32] Texture: whiteSquare.bmp	Moveable?:  true
BLOCK[47][33] Texture: whiteSquare.bmp	Moveable?:  true
BLOCK[47][34] Texture: blackSquare.bmp	Moveable?: *false
BLOCK[47][35] Texture: whiteSquare.bmp	Moveable?:  true
BLOCK[47][36] Texture: whiteSquare.bmp	Moveable?:  true
BLOCK[47][37] Texture: whiteSquare.bmp	Moveable?:  true
BLOCK[47][38] Texture: blackSquare.bmp	Moveable?: *false
BLOCK[47][39] Texture: whiteSquare.bmp	Moveable?:  true
BLOCK[47][40] Texture: whiteSquare.bmp	Moveable?:  true
BLOCK[47][41] Texture: whiteSquare.bmp	Moveable?:  true
BLOCK[47][42] Texture: whiteSquare.bmp	Moveable?:  true
BLOCK[47][43] Texture: whiteSquare.bmp	Moveable?:  true
BLOCK[47][44] Texture: whiteSquare.bmp	Moveable?:  true
BLOCK[47][45] Texture: whiteSquare.bmp	Moveable?:  true
BLOCK[47][46] Texture: blackSquare.bmp	Moveable?: *false
BLOCK[47][47] Texture: whiteSquare.bmp	Moveable?:  true
BLOCK[47][48] Texture: blackSquare.bmp	Moveable?: *false
BLOCK[48][0] Texture: blackSquare.bmp	Moveable?: *false
BLOCK[48][1] Texture: blackSquare.bmp	Moveable?: *false
BLOCK[48][2] Texture: blackSquare.bmp	Moveable?: *false
BLOCK[48][3] Texture: blackSquare.bmp	Moveable?: *false
BLOCK[48][4] Texture: blackSquare.bmp	Moveable?: *false
BLOCK[48][5] Texture: blackSquare.bmp	Moveable?: *false
BLOCK[48][6] Texture: blackSquare.bmp	Moveable?: *false
BLOCK[48][7] Texture: blackSquare.bmp	Moveable?: *false
BLOCK[48][8] Texture: blackSquare.bmp	Moveable?: *false
BLOCK[48][9] Texture: blackSquare.bmp	Moveable?: *false
BLOCK[48][10] Texture: blackSquare.bmp	Moveable?: *false
BLOCK[48][11] Texture: blackSquare.bmp	Moveable?: *false
BLOCK[48][12] Texture: blackSquare.bmp	Moveable?: *false
BLOCK[48][13] Texture: blackSquare.bmp	Moveable?: *false
BLOCK[48][14] Texture: blackSquare.bmp	Moveable?: *false
BLOCK[48][15] Texture: blackSquare.bmp	Moveable?: *false
BLOCK[48][16] Texture: blackSquare.bmp	Moveable?: *false
BLOCK[48][17] Texture: blackSquare.bmp	Moveable?: *false
BLOCK[48][18] Texture: blackSquare.bmp	Moveable?: *false
